wwwwwwwwwwwww
w.......wgw.w
w.w.w...w.w.w
w.w...w1..2.w
wwwww.w...www
w.A.........w
w.w....ww.w1w
w..........+w
wwwwwwwwwwwww
