wwwwwwwwwwwww
wg.1........w
w2w.ww..w...w
w1w.....w...w
w.w.w.w.....w
w.w...w.....w
w.www..A..w.w
w.......w..+w
wwwwwwwwwwwww
