wwwwwwwwwwwww
w...A.....w.w
ww....w.w...w
w...........w
w.w.w.w.w.wgw
w.......w...w
w.ww....www.w
w+...2.....3w
wwwwwwwwwwwww
