wwwwwwwwwwwww
w...w.......w
w...w.w...w.w
w........1+.w
w...w.w..wwgw
wA..........w
w...w.w..w..w
w...w.....2.w
wwwwwwwwwwwww
