wwwwwwwwwwwww
w.g...w.....w
w.2.w.w.ww..w
w...w.w.....w
w.w...w..Aw.w
w.w.........w
w1w.....w...w
w...2......+w
wwwwwwwwwwwww
