wwwwwwwwwwwww
w...w..3.g.3w
w.w.www..2www
w.........w.w
www...w..ww.w
w...........w
w.w.A.ww..w.w
w.........+.w
wwwwwwwwwwwww
