wwwwwwwwwwwww
w...w.A...w.w
w.....w.w...w
w...w.......w
w2.....ww.w+w
w....1......w
w.w......w.ww
w.g.w.w.....w
wwwwwwwwwwwww
