wwwwwwwwwwwww
w1..w......+w
w.www.w.w...w
w.....w..Aw.w
w.w...w...www
w...........w
wg......w...w
w..2........w
wwwwwwwwwwwww
