wwwwwwwwwwwww
w.......g.w.w
ww.www....w.w
w..........3w
w.w.w.ww..w.w
wA..........w
w.www.w.w...w
w.........2+w
wwwwwwwwwwwww
