wwwwwwwwwwwww
w.w.........w
w.www.w....ww
w..A....w..3w
www.www.w.wgw
w...w.....w.w
w...www....3w
w+........w.w
wwwwwwwwwwwww
