wwwwwwwwwwwww
w.w........gw
w...www.w.w.w
w.w.......3.w
w.....w...w.w
w.+..A......w
w2www....wwww
w...........w
wwwwwwwwwwwww
