wwwwwwwwwwwww
w...wA......w
w.......www.w
w.......w...w
www.w...w3..w
w.......w..+w
w3w.......www
w.g...w3....w
wwwwwwwwwwwww
