wwwwwwwwwwwww
wA..w.....w.w
w...w.w..ww.w
w.........g.w
w.w.w....w3+w
w........3..w
ww..w.w.www.w
w.....w....1w
wwwwwwwwwwwww
