wwwwwwwwwwwww
w+.....2..w.w
w.ww..w.w.w.w
w....A..w...w
w.www.www.wgw
w.......w...w
w.w..ww...w.w
w......3w.2.w
wwwwwwwwwwwww
