wwwwwwwwwwwww
w3..w.w....gw
w..2..www.w.w
w...........w
w.w.w.w.w...w
w.w.w.A.....w
w.w.ww..w.w.w
w+......w...w
wwwwwwwwwwwww
