wwwwwwwwwwwww
wg......w...w
w+w2w.w.www.w
w...........w
w.w.w.w.w.www
w.w...3.....w
w1w.w....ww.w
w.........A.w
wwwwwwwwwwwww
