wwwwwwwwwwwww
w...........w
w........A..w
w.....w...w.w
w.www.w.w.w.w
wgw.........w
w.w..2..w...w
w.w.2.....+.w
wwwwwwwwwwwww
