wwwwwwwwwwwww
w....+......w
www.w.w.....w
w.2.w.......w
w..2www.w.w.w
w..g......w.w
ww..w...w..Aw
w...........w
wwwwwwwwwwwww
