wwwwwwwwwwwww
w2.g..w...w+w
w.www...w.w3w
w...2.......w
w.w...w.....w
w.w.........w
w.......w.w.w
w.....A.....w
wwwwwwwwwwwww
