wwwwwwwwwwwww
w2g.........w
w.w.w...w...w
w.3.........w
w.www.w.w...w
w1w.w.....wAw
w.w...w.w.w.w
w...+.......w
wwwwwwwwwwwww
