wwwwwwwwwwwww
w.w.....w...w
w.w.w3..w.w.w
w.+.........w
www.w..ww.wAw
w...32..w...w
w...w.www.w.w
wgw.......w.w
wwwwwwwwwwwww
