wwwwwwwwwwwww
w.....wAw...w
w.w.........w
w...........w
w.w.www.w.www
w...........w
w...www...w+w
w2g.......2.w
wwwwwwwwwwwww
