wwwwwwwwwwwww
w.g.3.w....+w
w3..w....ww.w
w...........w
w.www.....w.w
w.w.....w...w
www...w.w...w
w...w...A...w
wwwwwwwwwwwww
