wwwwwwwwwwwww
w.wg........w
w+w.w.w...w.w
w1w.......w.w
w3w.....w...w
w.......A...w
w.....www...w
w...........w
wwwwwwwwwwwww
