wwwwwwwwwwwww
w2..w......+w
wgwww.w...w.w
w.1.w.......w
w...w...www.w
w...........w
w.......wAw.w
w...........w
wwwwwwwwwwwww
