wwwwwwwwwwwww
w.2.........w
ww....wwwA..w
w.2.w.......w
ww....w.wwwww
w...........w
wgw.www...w.w
w.w..2..+...w
wwwwwwwwwwwww
