wwwwwwwwwwwww
w+.3w.......w
www.w.w...www
w.g.w.....w.w
w.w.w.www...w
w.w.......A.w
www...w...w.w
w3..w.w.....w
wwwwwwwwwwwww
