wwwwwwwwwwwww
w.....A.....w
w...www...w.w
w...........w
w...w.www.w.w
w...........w
w3www..ww.w+w
w1g.........w
wwwwwwwwwwwww
