wwwwwwwwwwwww
w...w.w.....w
w.....w...w.w
w.....2.A...w
w+w.w...www.w
w2....1...w.w
w...www...w.w
w.wg........w
wwwwwwwwwwwww
