wwwwwwwwwwwww
w.........w.w
www...w...wgw
wA..w..2..w.w
w.w.wwww..w2w
w.w.........w
w.w......+.ww
w.....w.w...w
wwwwwwwwwwwww
