wwwwwwwwwwwww
w2.2......w.w
w.w.w..w.ww.w
wgw.w.......w
w.w....ww...w
w...........w
ww....A.w..ww
w.......w..+w
wwwwwwwwwwwww
