wwwwwwwwwwwww
w.....w.w.+2w
w.www....2w.w
w.w.........w
w...w.w.www.w
wA..........w
w...w.w..wwgw
w.....w.....w
wwwwwwwwwwwww
