wwwwwwwwwwwww
w..........gw
w.w.w.w....ww
w..A........w
w.....w.w.w.w
w..........3w
www.....w.w.w
w+........23w
wwwwwwwwwwwww
