wwwwwwwwwwwww
w.....w.w...w
w...w.w.w...w
w...A.......w
w...w.w.w.w.w
w.........1gw
w...w.www.w.w
w.+........2w
wwwwwwwwwwwww
