wwwwwwwwwwwww
wg.1........w
w.w3www.....w
w..+..w.....w
w1w...w.....w
w.....w.....w
w.w.www.w.w.w
w..........Aw
wwwwwwwwwwwww
