wwwwwwwwwwwww
w.........g1w
w.w.w.....www
w.w...w.....w
w.wwwww.w.w.w
w..........1w
w.w..A....w.w
w.+.......w.w
wwwwwwwwwwwww
