wwwwwwwwwwwww
w.......w..2w
ww.ww...w.w.w
w.....A.....w
w.....www...w
w..2.......gw
w.www.www.www
w.+.........w
wwwwwwwwwwwww
