wwwwwwwwwwwww
wg2.1.......w
wwwww...w...w
w...........w
w.ww..w.w.w.w
w2..........w
w.ww..wwwAw.w
w..........+w
wwwwwwwwwwwww
