wwwwwwwwwwwww
w...3......+w
w.w.w.....w.w
w.........w.w
w1w.w.wAw...w
w...w......1w
w.w.w..ww.w.w
wg..........w
wwwwwwwwwwwww
