wwwwwwwwwwwww
w.3.......1gw
www.w..www..w
w.w.........w
w+www...w.w.w
w2.....A..w.w
www.w...www.w
w...w.....w.w
wwwwwwwwwwwww
