wwwwwwwwwwwww
w.....w.....w
w.w.......wAw
w...........w
wwwww.......w
w..2g.......w
w.w.w.ww.wwww
w.1+w.......w
wwwwwwwwwwwww
