wwwwwwwwwwwww
wg3.........w
w.w2w.w.www.w
w.1.........w
w...w.w...w.w
w...........w
w.w...wA..www
w.w........+w
wwwwwwwwwwwww
