wwwwwwwwwwwww
w.......w.w.w
w..1w.www.w+w
w.....A.....w
w.www.www.w.w
w...........w
w...w.w..ww.w
wgw........1w
wwwwwwwwwwwww
