wwwwwwwwwwwww
w2........+1w
www.w...www.w
w..3..w.....w
w.w.w...w...w
wg..w...w.w.w
www...w.w...w
w.......A...w
wwwwwwwwwwwww
