wwwwwwwwwwwww
w.....w.1.g.w
w.....w.www.w
w.w.........w
w.w.www.w.3.w
w....A......w
ww..w.....w.w
w...w......+w
wwwwwwwwwwwww
