wwwwwwwwwwwww
w...........w
w.w.w.wAw..ww
w...w.......w
w...w3www.www
w...........w
wgwww.www.w.w
w1.+.......1w
wwwwwwwwwwwww
