wwwwwwwwwwwww
w...w.w...w.w
w.w...w..Aw.w
w...w.......w
ww1.....www.w
w+..........w
wwwww...www.w
w3..g.....w.w
wwwwwwwwwwwww
