wwwwwwwwwwwww
w+..1.......w
www.ww..w.w.w
w...w...w.wAw
w......ww.w.w
w.........w.w
w...w...w...w
wgw.3.......w
wwwwwwwwwwwww
