wwwwwwwwwwwww
w.w...w.....w
wA...ww.w.w.w
w..........1w
w..w.w..w.w+w
w.........w.w
w..wwww..2w.w
w.......2.g.w
wwwwwwwwwwwww
