wwwwwwwwwwwww
w2.g........w
w.w.w.w.w.w.w
w....2......w
w+wwwww.www.w
w.....3...w.w
w.......wAw.w
w...........w
wwwwwwwwwwwww
