wwwwwwwwwwwww
w.3.w...+...w
wg..w.w..ww.w
w.w...w...w.w
www...www...w
w1..........w
w..w.......Aw
w.....w.....w
wwwwwwwwwwwww
