wwwwwwwwwwwww
w....A..w.w.w
www.www.w...w
w...w.......w
w+w....3..13w
w...........w
w....ww..gw.w
w.....w...w.w
wwwwwwwwwwwww
