wwwwwwwwwwwww
w+........wgw
w.1ww...w.11w
w...........w
w...w...ww..w
w.......w...w
w.wwwww...w.w
w.....A.w.w.w
wwwwwwwwwwwww
