wwwwwwwwwwwww
w..........gw
w.www....2.1w
w........+..w
w.wwwww.w.w.w
w.w.w.w.....w
w.....w....ww
wAw.....w...w
wwwwwwwwwwwww
