wwwwwwwwwwwww
w.w2......w+w
w.w...w...w.w
w.....A.....w
w2......w.w.w
wg........w.w
w.w.w.w.....w
w...........w
wwwwwwwwwwwww
