wwwwwwwwwwwww
w1......w...w
wwww..w..Aw.w
w.....w+....w
w.ww..ww.ww.w
w...........w
ww..w.w.w...w
wg..w.....1.w
wwwwwwwwwwwww
