wwwwwwwwwwwww
w..........+w
w2w.w.....w.w
w.wgw...w.w.w
w.w1w.www.w.w
w.w.........w
w.w.....w.w.w
w.......A...w
wwwwwwwwwwwww
