wwwwwwwwwwwww
w2..w......+w
w...www.w3w.w
w...........w
www.......w1w
w.......w...w
ww.Aw.w...www
w...w...w..gw
wwwwwwwwwwwww
