wwwwwwwwwwwww
wg....w...w.w
w3w.w.w.....w
w...........w
wwwww.w.www.w
w...w......Aw
w...........w
w.2......+..w
wwwwwwwwwwwww
