wwwwwwwwwwwww
w3..w.w.w..gw
www.....w.www
w...w.......w
w+w.w..ww...w
w..3w.......w
ww..w...A.www
w...........w
wwwwwwwwwwwww
