wwwwwwwwwwwww
w.......w.w.w
w.wAw...w...w
w...w.......w
w.w.......w.w
w.........w2w
w.w.w.w.www.w
w.w.w1w...+gw
wwwwwwwwwwwww
