wwwwwwwwwwwww
w...........w
w.w.w.A.w...w
w.....w.w...w
w+w...w.w.w.w
w...w2......w
w1www...w.w2w
w.w.......wgw
wwwwwwwwwwwww
