wwwwwwwwwwwww
w....3..w.w+w
w.www....g..w
w...........w
w.ww..w.w...w
w.A.........w
w.w...w.w.w.w
w.....w..1..w
wwwwwwwwwwwww
