wwwwwwwwwwwww
w.......w.w.w
w3.+..w.w...w
w...........w
w.......Aww.w
w...........w
w.w.www.www.w
wg...2w.....w
wwwwwwwwwwwww
