wwwwwwwwwwwww
w.w.......3.w
w.w+....w.w.w
w.........w.w
w.wwwA......w
w.........1.w
w.w.w.w.w.w.w
w3........g.w
wwwwwwwwwwwww
