wwwwwwwwwwwww
w.w.....w..gw
w.www.w.w.w.w
w.w........2w
w.w....wwww+w
w.........w.w
wA....www.w.w
w.w.......1.w
wwwwwwwwwwwww
