wwwwwwwwwwwww
w...........w
w+w...w...w.w
w.w.......3.w
w.w.A..w..w.w
w.........wgw
w.......w.www
w.....w.w.3.w
wwwwwwwwwwwww
