wwwwwwwwwwwww
w.w.....1...w
w.w.w...w.www
w+..w.....w.w
w.w.ww....w.w
w..........gw
w.w..Aw.w2www
w.2.........w
wwwwwwwwwwwww
