wwwwwwwwwwwww
w.......w.w.w
ww..w.w.w.A.w
w...g.......w
ww1.www...w.w
w...w3......w
wwwww.......w
w.....w.w..+w
wwwwwwwwwwwww
