wwwwwwwwwwwww
w.1.w...2..gw
w.w...w.w.w.w
w.w......3w.w
www.w.w.w.www
w.w.w.A.....w
w+w.w.w..w.ww
w...........w
wwwwwwwwwwwww
