wwwwwwwwwwwww
w.........A.w
w.....w.w.w.w
w...........w
www3....www.w
w2g...w.....w
w.w.www.www.w
w1w...+.....w
wwwwwwwwwwwww
