wwwwwwwwwwwww
w........A..w
wgw.w...ww..w
w1w.........w
w.w.w.w...www
w.w.........w
w2..w.www.w.w
w3..w.....w+w
wwwwwwwwwwwww
