wwwwwwwwwwwww
w...w.......w
w3........w.w
w.....w.....w
w..ww.w.w.wAw
w.g.2.....w.w
ww.......ww.w
w..+......w.w
wwwwwwwwwwwww
