wwwwwwwwwwwww
w3........w.w
wg..w..ww...w
w.......w...w
w..ww.w.wwwAw
w...w.......w
w1www+w.w.w.w
w.......w...w
wwwwwwwwwwwww
