wwwwwwwwwwwww
w+........wgw
w...ww.ww3..w
w...........w
w.w...w.w...w
w.w........1w
w...wA..www.w
w.w.......w.w
wwwwwwwwwwwww
