wwwwwwwwwwwww
w..3....w.3.w
wgw.w.w.ww..w
w...w.w.....w
w.wwwwww...ww
w...........w
ww..ww..w..+w
w......A..w.w
wwwwwwwwwwwww
