wwwwwwwwwwwww
w...w.......w
w.w.....w.w+w
w..A........w
www.w.w.www.w
w..........3w
w.w.w.w.gww.w
w...w......3w
wwwwwwwwwwwww
