wwwwwwwwwwwww
w..........gw
w.w...w...www
wA..........w
w.w.w.w..1w.w
w...........w
w.w.w...w.w.w
w......+..1.w
wwwwwwwwwwwww
