wwwwwwwwwwwww
w..........2w
w.w.w...w..1w
w.........g.w
www.w.w.w.w.w
w.w.w.w...w.w
w.....A.w.www
w+..........w
wwwwwwwwwwwww
