wwwwwwwwwwwww
w+..w.......w
w...www.w...w
w.......w...w
ww..A.w.w.w2w
w.....w....1w
w.w.w.www.wgw
w.w.........w
wwwwwwwwwwwww
