wwwwwwwwwwwww
w.......w+..w
www.w.w...2.w
wA..w.......w
w...w...w...w
w...w.......w
w.....wwwwwgw
w.w......1w2w
wwwwwwwwwwwww
