wwwwwwwwwwwww
w..2+.......w
w...w.w.....w
w..3w.......w
w.w.w.w.w...w
w.........A.w
www.......www
w.g.w...w...w
wwwwwwwwwwwww
