wwwwwwwwwwwww
w.........w.w
w....A..w...w
w.....w.w...w
w.www.w.w..ww
w.w........gw
www.........w
w..+.....232w
wwwwwwwwwwwww
