wwwwwwwwwwwww
w1+.........w
w.w...ww....w
w.w3........w
w.w.w..w....w
w...w.....A.w
w.w.www.w.www
w..g........w
wwwwwwwwwwwww
