wwwwwwwwwwwww
w...w.w.w.1gw
w.w.w.w...w2w
w.w.........w
w.....w.w..ww
w...........w
w..Aw.www.w.w
w...w....+w.w
wwwwwwwwwwwww
