wwwwwwwwwwwww
w.......w...w
wwwww.w.A...w
wg......w...w
w.w.w...w.w.w
w.w.........w
w.w.w.www.w.w
w21..1....+.w
wwwwwwwwwwwww
