wwwwwwwwwwwww
wg........w.w
w.w.w.w.wAw.w
w.....w.....w
w.1.w.w.w...w
w...........w
w1w.w.....w+w
w...........w
wwwwwwwwwwwww
