wwwwwwwwwwwww
w.w.......w.w
w.w.w.w.w.w.w
w...wA......w
www.w...w.w3w
w+......w.w.w
w...www....gw
w.........13w
wwwwwwwwwwwww
