wwwwwwwwwwwww
w+w...A.....w
w.w.........w
w.......w.w.w
w3......w.w.w
w.w.w.......w
w.w.w.w.w...w
w.........g1w
wwwwwwwwwwwww
