wwwwwwwwwwwww
w.........+.w
w...w..ww.www
wAw.........w
w.w.wwww..w.w
w.........w.w
www..1w.wgw.w
w.......w.w2w
wwwwwwwwwwwww
