wwwwwwwwwwwww
w.......w..gw
w...w...w.3ww
w..........3w
w..ww.www.w2w
wA..w.w.w...w
ww....w...www
w.......+...w
wwwwwwwwwwwww
