wwwwwwwwwwwww
w+........w.w
www.w...w...w
w...........w
w.w.www...wAw
w...........w
w.w.w.w.w...w
wg1...2.....w
wwwwwwwwwwwww
