wwwwwwwwwwwww
wg....w.....w
w.w...w.w.w3w
w1w...w.w...w
w.w.w.w.w.www
w...1.......w
w.w...wAw...w
w.w.....w..+w
wwwwwwwwwwwww
