wwwwwwwwwwwww
w...........w
w..3.ww...wgw
w.........2.w
w.w.w.w.wwwww
w...w.w.w...w
w..+..w.....w
w.....A.....w
wwwwwwwwwwwww
