wwwwwwwwwwwww
w.....w.w...w
w...w.....www
wAw.......w.w
w.w.www...w+w
w.......w...w
w..ww...ww.ww
w...w.w..1g2w
wwwwwwwwwwwww
