wwwwwwwwwwwww
w........1g2w
w.wwwww.w...w
w...w.......w
w.wAw..ww..ww
w.......w...w
www....ww.www
w..2....w.+.w
wwwwwwwwwwwww
