wwwwwwwwwwwww
w.........2gw
w...www..+w.w
w.....w.w.w.w
w...w.w.w2w.w
w...........w
www.....www.w
w.A...w.....w
wwwwwwwwwwwww
