wwwwwwwwwwwww
w.+.........w
w.....w.www.w
w.2........Aw
w.www.w..w.ww
w1w.w.......w
w.g3........w
w.....w.....w
wwwwwwwwwwwww
