wwwwwwwwwwwww
w.w.....w.w.w
w.wwwww.g+1.w
w.......1.w.w
w...w.w.w.3.w
w...w.w...w.w
w...w.......w
wA..........w
wwwwwwwwwwwww
