wwwwwwwwwwwww
w.w.A...w.w.w
w.w..w..w.w.w
w.w........gw
w.www.w...w.w
w...w.......w
ww..www.w...w
w2...2.3.+w.w
wwwwwwwwwwwww
