wwwwwwwwwwwww
w3w.......wgw
w.w...w.....w
w.2.........w
w+wwww....w.w
w...........w
w.w.....w.w.w
w.w....A....w
wwwwwwwwwwwww
