wwwwwwwwwwwww
w...........w
w.wwA.w.w.w.w
w........1.gw
w.w.www...w.w
w.........3.w
w.w.w.ww....w
w.+......2..w
wwwwwwwwwwwww
