wwwwwwwwwwwww
w.....w.w...w
w.wwwww...11w
w+........wgw
www..ww.www.w
w...........w
w.....w.w.w.w
w.....A.w...w
wwwwwwwwwwwww
