wwwwwwwwwwwww
w.w..3......w
w3ww.w.ww.w.w
w+..g...w...w
www.www.w.w.w
w...........w
w...w.w....ww
w.........A.w
wwwwwwwwwwwww
