wwwwwwwwwwwww
w....A....w.w
w...w.wwwww.w
w.......3...w
ww.....ww...w
w..........gw
w.wwwww.w.www
w.+...w.w..1w
wwwwwwwwwwwww
