wwwwwwwwwwwww
w...w.2....2w
w.....w.www+w
w.w........gw
w...w.w.w.w.w
wA....w....3w
w.........w.w
w...........w
wwwwwwwwwwwww
