wwwwwwwwwwwww
w.......w..Aw
w.w.w3w.w.w.w
w...........w
w.www..w..w.w
w.g.......w.w
w.2.w.w.wwwww
w+..w.......w
wwwwwwwwwwwww
