wwwwwwwwwwwww
w...w....+.3w
ww..w...w.gww
w.A.........w
www...www.www
w........2..w
w.w..ww.w.www
w.w.....w.2.w
wwwwwwwwwwwww
