wwwwwwwwwwwww
wg......w3..w
w.w.w.w.w.www
w...w.......w
w.w.w.w.ww.3w
w....A.....+w
w..ww...ww.ww
w...w.......w
wwwwwwwwwwwww
