wwwwwwwwwwwww
w.....w...1gw
w.w.wwww.3www
w.w...w.....w
w.....w.....w
w...A.......w
w.w..ww.w.w.w
w+........w.w
wwwwwwwwwwwww
