wwwwwwwwwwwww
wg.2w..2....w
www.....w...w
w2..........w
w.w+w....w..w
w...........w
w.....w.w.wAw
w...w...w...w
wwwwwwwwwwwww
