wwwwwwwwwwwww
wgw.w...w...w
w...2....3..w
w...w.....w.w
w..ww.w.w.w+w
w...........w
w...w...w.w.w
w.w....A....w
wwwwwwwwwwwww
