wwwwwwwwwwwww
w.w.1......gw
w.w.w.www.w2w
w.A...w..1..w
ww..w...w.www
w.......w...w
w...w.w.w.w.w
w.w....+..w.w
wwwwwwwwwwwww
