wwwwwwwwwwwww
w3..w....+..w
w.w.w.wwwww.w
w...w3....w.w
w...w...A.w.w
w...........w
wgw....w..w.w
w.w.......w.w
wwwwwwwwwwwww
