wwwwwwwwwwwww
w.+.........w
w.ww..w..Awww
w3....w.....w
w3w.w.w.w.w.w
w...........w
w.g...w.w...w
w...w.......w
wwwwwwwwwwwww
