wwwwwwwwwwwww
wg.......3..w
www.w.w.w...w
w.....w.w.w.w
w.www.wAw...w
w.w.w...w...w
w.....w.w.w+w
w.....w....1w
wwwwwwwwwwwww
