wwwwwwwwwwwww
w..+......w.w
w...w.....3gw
w..........3w
wwwww.w...w.w
w.....w.....w
w.w...w...w.w
w...A.......w
wwwwwwwwwwwww
