wwwwwwwwwwwww
w.+.........w
w.2...A.....w
w...........w
www...w...w.w
w...........w
w.......www.w
w.........g.w
wwwwwwwwwwwww
