wwwwwwwwwwwww
wg.1........w
w...w.w.w.w.w
w...........w
w...1....A..w
w...........w
w.w.w.......w
w.........+.w
wwwwwwwwwwwww
