wwwwwwwwwwwww
wwwwwwwwwwwww
www...A...www
www.+.....www
www...w...www
www.1.....www
www....g.2www
wwwwwwwwwwwww
wwwwwwwwwwwww
