wwwwwwwwwwwww
w.+.w...w.w.w
w.w.w2w.w2w.w
w.......w...w
w.....www.www
w.A.........w
w.w...w.w...w
w.......w.g.w
wwwwwwwwwwwww
