wwwwwwwwwwwww
w...w.......w
w.w.w.w.w..ww
w..........+w
w.w.wwww.wwww
w.2.w...A...w
w2..w.w..ww.w
wg........w.w
wwwwwwwwwwwww
