wwwwwwwwwwwww
w.w...w.w.g.w
w.......w...w
w.A.........w
www.......w.w
w...........w
ww...ww.w.w.w
w......+w1.3w
wwwwwwwwwwwww
