wwwwwwwwwwwww
w..........+w
wA..w.w.w.w1w
w...w...w.w.w
www.w.w.....w
w.w........1w
w.w....ww.w.w
w........gw.w
wwwwwwwwwwwww
