wwwwwwwwwwwww
w...w.....+.w
w...ww..w.www
w...A...w...w
w.w.w.w.....w
w...w.....w.w
w.w.www.3ww.w
w.g...w..2w.w
wwwwwwwwwwwww
