wwwwwwwwwwwww
w.w+....w...w
w.w.w.Aww.w.w
w...w.......w
w...w.w.www.w
w.....w....2w
w.....w.w.wgw
w1..w.......w
wwwwwwwwwwwww
