wwwwwwwwwwwww
w.w..A....w.w
w.ww.w.w..w.w
w...........w
wwww.ww.w...w
w......3..g.w
w...w.www+w.w
w...w......3w
wwwwwwwwwwwww
