wwwwwwwwwwwww
w2...+......w
w.w...w.w.w.w
w.......w...w
w.....www...w
w.2.w.....wAw
w.........www
w.g.........w
wwwwwwwwwwwww
