wwwwwwwwwwwww
w.....A.w...w
w.www.w.w.w.w
w.w.........w
w.w.w.w.w.w.w
w.........w.w
www.w.w...w1w
w+g...w...3.w
wwwwwwwwwwwww
