wwwwwwwwwwwww
w.........+.w
w.ww..w.w...w
w.........w.w
wA..w.w.w.w.w
w.w.w.w...3.w
w.w.w.www..gw
w.....w.2...w
wwwwwwwwwwwww
