wwwwwwwwwwwww
wg........w.w
w...w.www.w.w
w.......w.1.w
w.w.www.w+.1w
w....A..w...w
w.w.....wwwww
w.....w....3w
wwwwwwwwwwwww
