wwwwwwwwwwwww
w3....g.....w
w..3.3w..w..w
w...........w
wwwww.w..w..w
w...w...A...w
w+........w.w
w.w.....w...w
wwwwwwwwwwwww
