wwwwwwwwwwwww
w.......g.2.w
www.....w.w3w
w+2.........w
w.w...w...w.w
w.w.........w
w.w.w.w.w...w
w...wA....w.w
wwwwwwwwwwwww
