wwwwwwwwwwwww
w...g.......w
w.3...w.w...w
w.2..1....w.w
w.w.w...www.w
w+..........w
w...www...A.w
w.w.......w.w
wwwwwwwwwwwww
