wwwwwwwwwwwww
w3.g..w.w...w
w.w...w.w.2ww
w...........w
w.w.w..w...ww
w.w....A....w
wwwww.w..wwww
w..........+w
wwwwwwwwwwwww
