wwwwwwwwwwwww
w..........gw
ww......w.w.w
wA....w...w.w
w.w.w.....w.w
w...w.w.w.w.w
w...w.....w+w
w.w.w...w2w2w
wwwwwwwwwwwww
