wwwwwwwwwwwww
w.w.........w
w.w.www.w.w.w
w....1....g3w
w...w.ww....w
wA..........w
www.w.w...w.w
w...w...+.w.w
wwwwwwwwwwwww
