wwwwwwwwwwwww
wA......w...w
w..wwww....ww
w.....w....gw
w..ww.wwwww.w
w.....w.....w
www...w.w..+w
w.......23.1w
wwwwwwwwwwwww
