wwwwwwwwwwwww
w.g.1.......w
www.....w.w.w
w.....w.....w
w.www.w..w.ww
w.........A.w
www.w.wwwww.w
w....3..+...w
wwwwwwwwwwwww
