wwwwwwwwwwwww
w.w.........w
w....Awww...w
w.3.........w
w..ww.www.www
w..2w.......w
w.w.www..+www
w1w.....g...w
wwwwwwwwwwwww
