wwwwwwwwwwwww
w.....w.....w
w..ww.w.w...w
w........A..w
w2w.www.w...w
w.........w.w
w.w.w.w..ww.w
w3+g........w
wwwwwwwwwwwww
