wwwwwwwwwwwww
w...w....2..w
w.w.w.w.w.w.w
wg..........w
www3..w.....w
w.......A...w
w.........www
w.1...w....+w
wwwwwwwwwwwww
