wwwwwwwwwwwww
w..A........w
w...w...w.w.w
w...........w
w.www.w.w...w
w.........1gw
w...w.w...w2w
w..........+w
wwwwwwwwwwwww
