wwwwwwwwwwwww
w...w.......w
w.w.wAww..w.w
w...........w
www.www.2..ww
w..1..w...1.w
w.w...www.wgw
w+..w...w...w
wwwwwwwwwwwww
