wwwwwwwwwwwww
w.....w.1..+w
w...w.www..ww
w...........w
w...w.w...www
w..A..3.w.2.w
w.w..ww.g.www
w.w...w.....w
wwwwwwwwwwwww
