wwwwwwwwwwwww
w.......w...w
www.www.www.w
w...A.....w.w
w.ww..w.w.31w
w.........w.w
w.w.w.www.wgw
w.+...3.....w
wwwwwwwwwwwww
