wwwwwwwwwwwww
w...w...g.w.w
ww..w.w....2w
w.....w...w.w
w...w...w.w.w
w.......w..1w
w...www....ww
wAw........+w
wwwwwwwwwwwww
