wwwwwwwwwwwww
w.......w..+w
w.1...w...w.w
w.....w.....w
www.w...wA..w
w...w.......w
wg.2..w...www
w...........w
wwwwwwwwwwwww
