wwwwwwwwwwwww
w.....w...3+w
w.w.w.w.w...w
w.....w...w.w
w..ww....ww.w
wA.......3w.w
ww..w...w.w.w
w.....1.wg..w
wwwwwwwwwwwww
