wwwwwwwwwwwww
w.+.....w...w
w...www...w.w
w....A......w
www..ww.ww..w
w...........w
w.w1.......gw
w.w.....3...w
wwwwwwwwwwwww
