wwwwwwwwwwwww
w.w.........w
w.w.w.wwwA..w
w...w...w...w
w...w.....w.w
w..2..w.w...w
wg..w.......w
w....2....+.w
wwwwwwwwwwwww
