wwwwwwwwwwwww
w.......w...w
w.w.wAw.w...w
w.......w...w
w.w.w.w.w.w.w
w.........g1w
w.w.w...www.w
w+w....2....w
wwwwwwwwwwwww
