wwwwwwwwwwwww
w.........+.w
w.www..1w.w.w
w.........w.w
w1..ww..www.w
w.w.A.....3.w
w....ww.w.www
w.......w..gw
wwwwwwwwwwwww
