wwwwwwwwwwwww
w..........Aw
w1w.w.w.w.w.w
w.....w.....w
w.w...w...w.w
w.+.....w.w.w
w.wg........w
w3w.w3w.....w
wwwwwwwwwwwww
