wwwwwwwwwwwww
w...w.w..3+3w
ww..w.w.w.w.w
w.........w.w
w.....w1w...w
w..A........w
www...w.www.w
w........g..w
wwwwwwwwwwwww
