wwwwwwwwwwwww
wgw.+.......w
w.ww..w.w.www
w.......w...w
w..w......A.w
w...........w
w.w...w...w.w
w...1..3....w
wwwwwwwwwwwww
