wwwwwwwwwwwww
w...w.w.....w
wA.ww...w...w
w...........w
w.www.w..ww3w
w...w....g..w
w...w.ww..w.w
w....+....2.w
wwwwwwwwwwwww
