wwwwwwwwwwwww
w3w...w.....w
w1.+w.....www
w...w.w.....w
www.w.www.www
wg........A.w
ww.www....w.w
w.........w.w
wwwwwwwwwwwww
