wwwwwwwwwwwww
w.w......g32w
w...w...www.w
w..........+w
w.w.ww....www
w.w.......w.w
wA.......ww.w
w...w.......w
wwwwwwwwwwwww
