wwwwwwwwwwwww
w.......g...w
w.w.w.www2w.w
w........1w.w
w...w..wwww.w
wA.........+w
w.w..ww.ww..w
w.w...w1....w
wwwwwwwwwwwww
