wwwwwwwwwwwww
w.g.w.......w
w.w.w.....www
w.w.....w..2w
w.wwww..w.w.w
w.....A.....w
w1..ww..w.w+w
w...w...w...w
wwwwwwwwwwwww
