wwwwwwwwwwwww
w...A.......w
www.w...w..ww
w...........w
www.w.www...w
w.w.....2.w.w
w...w.....www
w...w.w.g.3+w
wwwwwwwwwwwww
