wwwwwwwwwwwww
w...2......1w
w.....w..ww.w
w..........gw
w.w...w..wwww
w...........w
w.w.Aw..w.w.w
w..........+w
wwwwwwwwwwwww
