wwwwwwwwwwwww
w...w.......w
wAw.w.wwwww.w
w.........2.w
w.w.w.www...w
w.......w.w.w
w.w.w.gww1www
w........2+.w
wwwwwwwwwwwww
