wwwwwwwwwwwww
w.+...w.w..3w
w.w...w.w..gw
w.w......3..w
w.w.w.w.w.www
w.w.......w.w
w...w...w.w.w
w...A.......w
wwwwwwwwwwwww
