wwwwwwwwwwwww
w.....w....Aw
w.w.w.w....ww
w+1.........w
www...w.....w
w.....w.....w
w.w.3.w.....w
w2.g....w.w.w
wwwwwwwwwwwww
