wwwwwwwwwwwww
w.w......Aw.w
w.w.ww.w..w.w
w...........w
w.w.w.w.www.w
wg..w.......w
w.www.w.w...w
w..3..3....+w
wwwwwwwwwwwww
