wwwwwwwwwwwww
w...w...1.1.w
wgw.ww.w..w.w
w..1........w
w.w.w.www...w
w.........+.w
wwwww.w.w...w
w.....A.....w
wwwwwwwwwwwww
