wwwwwwwwwwwww
w.......g.w.w
w.www...w.w.w
w.w1........w
w.w...w.w1w.w
w.w..A......w
w+ww.w..w...w
w.....1.....w
wwwwwwwwwwwww
