wwwwwwwwwwwww
w...w.w....+w
w.w.w...ww.ww
w.A.........w
w.w.www.w...w
w...........w
w.w...w...g3w
w.w..2......w
wwwwwwwwwwwww
