wwwwwwwwwwwww
w...A.......w
w.w.w.w.w...w
w.....w.1.w.w
w.www.www...w
w.........1.w
w.ww..www.w.w
w+w.....2.wgw
wwwwwwwwwwwww
