wwwwwwwwwwwww
wg..........w
w....w..w.w.w
w...1...w...w
w.w.www.www.w
w.......A...w
w...w.w....1w
w1w...w....+w
wwwwwwwwwwwww
