wwwwwwwwwwwww
w1..A.......w
w.w.www.....w
w+......w...w
www...w.www.w
w...w...w..2w
w.w.w...w.w3w
w.w.w......gw
wwwwwwwwwwwww
