wwwwwwwwwwwww
w....1w...w.w
w...w.w2w.w+w
w...w..3...gw
w.w.w.w.w.www
w...........w
w...A...www.w
w...........w
wwwwwwwwwwwww
