wwwwwwwwwwwww
w...wg..w...w
w1w3w.w.ww..w
w...........w
w.w.w.w.w...w
w.w...w.....w
w+www...wwwAw
w.....w.....w
wwwwwwwwwwwww
