wwwwwwwwwwwww
w.w.....A...w
w.w.w.w...w.w
w.+.....w...w
w...w...w.w.w
w.2...w.....w
w.......w.w.w
w....3.....gw
wwwwwwwwwwwww
