wwwwwwwwwwwww
w.w.w.A.w...w
w.......w...w
w...........w
w.w.w...wwwww
w..g......w.w
w3....w.w.w.w
w....2....+.w
wwwwwwwwwwwww
