wwwwwwwwwwwww
w.........w.w
w.w.wAw.w.w.w
w.....w...w.w
w...www.w.w.w
w.........g.w
w.w......ww.w
w.w..1...2+1w
wwwwwwwwwwwww
