wwwwwwwwwwwww
w.......+.w.w
w........gw.w
w.......1.2.w
w...w.wwww..w
w.w.w.....2.w
wA..w...w.w.w
w.........w.w
wwwwwwwwwwwww
