wwwwwwwwwwwww
w.........+.w
w.........w.w
w.w.w...1..3w
w..Awww.w.www
w.w.....w...w
w.w.....w.www
w..........gw
wwwwwwwwwwwww
