wwwwwwwwwwwww
w.w....Aw.w.w
w.w.w.w.w...w
w.........w.w
w.ww..w.w...w
w.........2.w
www+..www.wgw
w.2.w.....w.w
wwwwwwwwwwwww
