wwwwwwwwwwwww
w.w..A....w.w
w.......w...w
w.......w.w.w
w.w.w.w.....w
w.+.........w
w...w.w...w.w
w..1.....g2.w
wwwwwwwwwwwww
