wwwwwwwwwwwww
w.2.....w..+w
w...w.www.w.w
w.......w...w
w.w.w.w.w.w3w
w.w....A..w.w
w...w.w.wwwww
wg..........w
wwwwwwwwwwwww
