wwwwwwwwwwwww
w..........gw
w.....w.w.3+w
w.....w2....w
w.w...w.w.w3w
w...........w
wAww....www.w
w...........w
wwwwwwwwwwwww
