wwwwwwwwwwwww
w3wg.3..w...w
w.w.ww....w.w
w.w.w...w...w
w.w2w.....w+w
w.........w.w
w.ww....w.w.w
w........A..w
wwwwwwwwwwwww
