wwwwwwwwwwwww
w........g2.w
w...w...w...w
w..+....w...w
w.w.w..www..w
w...w.......w
w3www..ww.w.w
w.....A...w.w
wwwwwwwwwwwww
