wwwwwwwwwwwww
w.......w..gw
w.w.w.w...www
w.2.w.......w
w.w.wwwww..ww
w......A....w
wwwww.w.....w
w.+......1..w
wwwwwwwwwwwww
