wwwwwwwwwwwww
w.........+gw
w.w.....w21.w
w...........w
ww..w.w...w.w
w...........w
www.w..ww3w.w
w.A.........w
wwwwwwwwwwwww
