wwwwwwwwwwwww
w...w.......w
w.w.www.+.w.w
w.....A.....w
w...w.w.w.w.w
w.........w.w
w.w1w.....www
wg........2.w
wwwwwwwwwwwww
