wwwwwwwwwwwww
w...w..3..+.w
w.....w.w1.ww
w..........1w
w.w.w.w...w.w
wA........w.w
w.w...w...wgw
w.......w.w.w
wwwwwwwwwwwww
