wwwwwwwwwwwww
wgw.w.......w
w..3www.w...w
w...........w
w.....w.ww..w
w.3...w.....w
www.www.w.wAw
w+..w.......w
wwwwwwwwwwwww
