wwwwwwwwwwwww
w+........g.w
w.www.ww..w1w
w1..........w
www...wwwww.w
w...........w
w.w.w.www..ww
w.w..A..w...w
wwwwwwwwwwwww
