wwwwwwwwwwwww
w.....w.w.w3w
w.w.w.....1.w
w.A.w.......w
w.www.w.w.w.w
w.....w.....w
w....ww...g2w
w..........+w
wwwwwwwwwwwww
