wwwwwwwwwwwww
w...g.......w
w+ww..w.w.w.w
w..2........w
w1w.w...w.w.w
w...w.....w.w
www.w...w...w
w.........A.w
wwwwwwwwwwwww
