wwwwwwwwwwwww
w......+.1..w
w.......www3w
w...w......2w
w...w.....w.w
w.....w...g.w
wAw...w..ww.w
w.w.w.......w
wwwwwwwwwwwww
