wwwwwwwwwwwww
w.......w.w.w
w.w.w.....2gw
w.w.......+2w
w.w.w...w1..w
w.w.....w.w.w
www.www.www.w
w.A.w.......w
wwwwwwwwwwwww
