wwwwwwwwwwwww
w.........w3w
wAw.www..ww.w
w.........w.w
w.ww.ww...w.w
w..........+w
w.......w.wgw
w.....w....1w
wwwwwwwwwwwww
