wwwwwwwwwwwww
w.........A.w
w...www..ww.w
w1....w.....w
www.w.....w.w
wg..........w
w1w.ww..w...w
w3+.w.......w
wwwwwwwwwwwww
