wwwwwwwwwwwww
w...........w
w.w.w.w.w.w.w
w.......w...w
w.....wA....w
w.g.........w
w.ww..w...w3w
w...1.w....+w
wwwwwwwwwwwww
