wwwwwwwwwwwww
w...w...w...w
w...w....2g.w
w...w.w.....w
w.A...w.w...w
w.....w.w...w
ww..w...www.w
w.....3+.3..w
wwwwwwwwwwwww
