wwwwwwwwwwwww
w......2.g..w
w.w.w.w...w.w
w........2w.w
w..ww.w..ww.w
w.........w.w
ww...ww...w+w
wA..........w
wwwwwwwwwwwww
