wwwwwwwwwwwww
w..........Aw
w.....w.w.www
w.+.w.......w
w...w...w...w
w...w2......w
w3w.w..w.w.ww
w1g.........w
wwwwwwwwwwwww
