wwwwwwwwwwwww
w+..w.w...w.w
www1w3..w.w.w
w.g.........w
www...w.w.www
w...w.w....Aw
www.www.....w
w.....2.....w
wwwwwwwwwwwww
