wwwwwwwwwwwww
w...2.......w
w.....ww....w
wgw...w.....w
w...w.w....Aw
w...w.....w.w
w...w.www...w
w+.1........w
wwwwwwwwwwwww
