wwwwwwwwwwwww
w........gw.w
w.....w.w...w
w2.........2w
w+...ww...w.w
w.w.....w...w
w.w.w.w.w..1w
w.w.wA......w
wwwwwwwwwwwww
