wwwwwwwwwwwww
w+......2...w
ww1.....www.w
w.2.w.w...w.w
www.w..Awww.w
w.w...w.....w
w...w.ww.ww.w
wg..........w
wwwwwwwwwwwww
