w....2...w
w++++++++w
w++++++++w
w++b++b++w
w+b+pp+b+w
w+ppbApp+w
w+b+bb+b+w
w++p++p++w
w++++++++w
w++++++++w
w......1.w
