w..2.....w
w++++++++w
w+p++++p+w
w++pppp++w
w+++Ap+++w
w++p++p++w
w+++pp+++w
w++pppp++w
w+p++++p+w
w++++++++w
w......1.w
