w..2.....w
w++++++++w
w+++pp+++w
w+pbppbp+w
w+pbbbbp+w
w++b++b++w
w++pApp++w
w++++++++w
w++p++p++w
w++++++++w
w..1.....w
