w....2...w
w++++++++w
w++++++++w
w+p+p++++w
w+p++ppp+w
w+++A+p++w
w+p++ppp+w
w+p+p++++w
w++++++++w
w++++++++w
w....1...w
