w..2.....w
w++++++++w
w++++++++w
w++pp+p++w
w+++pppp+w
w+pp+++++w
w+++pApp+w
w++pp+p++w
w++++++++w
w++++++++w
w......1.w
