w......2.w
w++++++++w
w++++++++w
w++b++b++w
w+bbAbbb+w
w+b++++b+w
w+bbbbbb+w
w++b++b++w
w++++++++w
w++++++++w
w..1.....w
