w......2.w
w++++++++w
w+p+pp+p+w
w+p++p+++w
w+p+pp+p+w
w++++Ap++w
w+p+pp+p+w
w+p++p+++w
w+p+pp+p+w
w++++++++w
w..1.....w
