w....2...w
w++++++++w
w+pp+++++w
w+p+pppp+w
w+++p+pp+w
w+p++A+p+w
w+++p+pp+w
w+p+pppp+w
w+pp+++++w
w++++++++w
w....1...w
