w....2...w
w++++++++w
w+ppp+pp+w
w+pp+++++w
w+++p+pp+w
w++p+A+p+w
w+++p+pp+w
w+pp+++++w
w+ppp+pp+w
w++++++++w
w....1...w
