w..2.....w
w++++++++w
w++++++++w
w+pppppp+w
w+p+++pp+w
w+++A++++w
w+p+++pp+w
w+pppppp+w
w++++++++w
w++++++++w
w......1.w
