wwwwwwwwwwwww
w..........+w
w.......w...w
w.......A...w
w...w...w...w
w...........w
wgw.....w...w
w2..........w
wwwwwwwwwwwww
