wwwwwwwwwwwww
w+..........w
w3g...w.....w
w...........w
w.....w.....w
w...........w
w.....w.....w
w..........Aw
wwwwwwwwwwwww
