wwwwwwwwwwwww
w..........gw
w.w.........w
w...........w
w...A.......w
w...........w
w.w.w....3w.w
w.+.........w
wwwwwwwwwwwww
