wwwwwwwwwwwww
w.........g.w
w.w.w...w...w
w...........w
w..A.....2w.w
w...........w
w.........w.w
w..........+w
wwwwwwwwwwwww
