wwwwwwwwwwwww
w..........+w
w...........w
w...........w
w.....w.....w
w...........w
w.......A...w
w..g........w
wwwwwwwwwwwww
