wwwwwwwwwwwwwwwwwwwwwwwwwwww
ww+++++++++++wgw+++++++++www
w000=000===00000000=000011ww
w0000====0000000====000031ww
ww+++++++++++++++++++++++www
w000000=000000000000====31ww
ww+++++++++++++++++++++++www
w...._..._l......ll.....l.ww
ww++++++++++++++A++++++++www
wwwwwwwwwwwwwwwwwwwwwwwwwwww
wwwwwwwwwwwwwwwwwwwwwwwwwwww
