wwwwwwwwwwwwwwwwwwwwwwwwwwww
wwwwwwwwwwwwwwwwwwwwwwwwwwww
ww++++++++++++++++wgw+++++ww
w000==00000==00000====00011w
w00000=00===000000000000031w
ww++++++++++++++++++++++++ww
w000====000000000=000=====1w
ww++++++++++++++++++++++A+ww
wwwwwwwwwwwwwwwwwwwwwwwwwwww
wwwwwwwwwwwwwwwwwwwwwwwwwwww
wwwwwwwwwwwwwwwwwwwwwwwwwwww
