wwwwwwwwwwwwwwwwwwwwwwwwwwww
ww+++++++++++++++++++wgw+www
w00000000=000====0000000=3ww
w0000=000000000000000000=3ww
ww+++++++++++++++++++++++www
w..--....-x....x-x........ww
w.l__l......ll_l....._lll.ww
w......ll_l......lll_.....ww
ww+++++++A+++++++++++++++www
wwwwwwwwwwwwwwwwwwwwwwwwwwww
wwwwwwwwwwwwwwwwwwwwwwwwwwww
