wwwwwwwwwwwwwwwwwwwwwwwwwwww
wwwwwwwwwwwwwwwwwwwwwwwwwwww
ww+++++++++++wgw+++++++++www
w00000====000000000==000=3ww
w..l_l.....__l_......._l..ww
w...--.....-x....x-x....x.ww
w.__......_l......ll__....ww
ww++++++++++++++++A++++++www
wwwwwwwwwwwwwwwwwwwwwwwwwwww
wwwwwwwwwwwwwwwwwwwwwwwwwwww
wwwwwwwwwwwwwwwwwwwwwwwwwwww
