wwwwwwwwwwwwwwwwwwwwwwwwwwww
ww++wgw++++++++++++++++++www
w000===00000000000000000=3ww
ww+++++++++++++++++++++++www
w00====00000==0000000===33ww
w00000===00000=000000=0033ww
w000=00===00000==0000000=3ww
ww+++++++++++++++++++++++www
ww+++++++++++++++++++++A+www
wwwwwwwwwwwwwwwwwwwwwwwwwwww
wwwwwwwwwwwwwwwwwwwwwwwwwwww
