wwwwwwwwwwwwwwwwwwwwwwwwwwww
wwwgw++++++++++++++++++++www
w00000===0000==00000=00011ww
w......._ll_........_l__..ww
w..ll....l.....l_......_..ww
ww+++++++++++++++++++++++www
w0===000000=000000====00=1ww
ww+++++++++++++++++++++++www
ww+++++++A+++++++++++++++www
wwwwwwwwwwwwwwwwwwwwwwwwwwww
wwwwwwwwwwwwwwwwwwwwwwwwwwww
