wwwwwwwwwwwwwwwwwwwwwwwwwwww
wwwgw+++++++++++++++++++++ww
w000000000=00000000000000=1w
w000==000000000=00000000=13w
w0000==00000====00000000=11w
w0000000000==000000=00000=3w
ww++++++++++++++++++++++++ww
w...ll...._..._l_....l_l...w
ww++++++++++++++++++++++A+ww
wwwwwwwwwwwwwwwwwwwwwwwwwwww
wwwwwwwwwwwwwwwwwwwwwwwwwwww
