wwwwwwwwwwwwwwwwwwwwwwwwwwww
ww+++++wgw+++++++++++++++www
w0====00000=000====0000013ww
w000000000000000000==00011ww
w00000=00000000===000000=3ww
w0000000====0000000===00=3ww
w0000=0000000====000000033ww
ww+++++++++++++++++++++++www
ww++++++++++A++++++++++++www
wwwwwwwwwwwwwwwwwwwwwwwwwwww
wwwwwwwwwwwwwwwwwwwwwwwwwwww
