wwwwwwwwwwwwwwwwwwwwwwwwwwww
wwwwwwwwwwwwwwwwwwwwwwwwwwww
ww+++++++++++++++++wgw++++ww
w0000000===0000000000000031w
w0====0000000000==000000=13w
w000000=00===00000000000=31w
w000000=0000000000000=000=3w
ww++++++++++++++++A+++++++ww
wwwwwwwwwwwwwwwwwwwwwwwwwwww
wwwwwwwwwwwwwwwwwwwwwwwwwwww
wwwwwwwwwwwwwwwwwwwwwwwwwwww
