wwwwwwwwwwwwwwwwwwwwwwwwwwww
wwwwwwwwwwwwwwwwwwwwwwwwwwww
w++++++++++++++++++++wgw++ww
....l....__ll.......l_l....w
...x-x....x--........xx--..w
w+++++++++++++++++++++++++ww
00000000000000=000==0000031w
..x-x-.........-...x---....w
w++++A++++++++++++++++++++ww
wwwwwwwwwwwwwwwwwwwwwwwwwwww
wwwwwwwwwwwwwwwwwwwwwwwwwwww
