wwwwwwwwwwwwwwwwwwwwwwwwwwww
wwgw+++++++++++++++++++++www
w0000000000000000000===033ww
w....l_........__.........ww
w...x-...x-...x-...--x-...ww
w._.._l__.....l_l_......_.ww
w..-xx.....x-...-x.....--.ww
ww+++++++++++++++++++++++www
ww+++++++++++++++A+++++++www
wwwwwwwwwwwwwwwwwwwwwwwwwwww
wwwwwwwwwwwwwwwwwwwwwwwwwwww
