wwwwwwwwwwwww
w..A..w.....w
w...w.......w
w...w.......w
w..ww.w..ww3w
w.........wgw
w...w.w...w.w
w3w.....+...w
wwwwwwwwwwwww
