wwwwwwwwwwwww
wg..........w
w......wwww+w
w.........w.w
w.......wwwww
w2..........w
w.w..w..w.w.w
w3.......A..w
wwwwwwwwwwwww
