wwwwwwwwwwwww
w.w.w.w...+.w
w.w....gwww.w
w...w...w.w.w
w...www...w1w
wA......w..3w
w.ww..w...w.w
w.w.....3...w
wwwwwwwwwwwww
