wwwwwwwwwwwww
w.w3......w+w
w.1.w.ww.ww.w
w.w...w.....w
w.w.www.wAwww
w.......w...w
w1w.www.w.www
w.g...3.....w
wwwwwwwwwwwww
