wwwwwwwwwwwww
w........g2.w
w+w.w.w.w...w
w1.......3..w
w...w.w.w...w
w...........w
w.www.w.....w
w...A.......w
wwwwwwwwwwwww
