wwwwwwwwwwwww
w.g.........w
w2..........w
w...........w
w.w...w.w...w
w.w.........w
w.w...wwA...w
w..+........w
wwwwwwwwwwwww
