wwwwwwwwwwwww
w...2......+w
w.w...w.w...w
w...........w
ww....w.w.g.w
w...........w
w...www...w.w
w..Aw.......w
wwwwwwwwwwwww
