wwwwwwwwwwwww
w..........+w
w.w.w...w.w.w
w...........w
w3g...w.....w
w........A..w
w...w.......w
w...........w
wwwwwwwwwwwww
