wwwwwwwwwwwww
wg.........2w
w.w.........w
w..........+w
w.w...w.....w
w...........w
w.......w.w.w
w........A..w
wwwwwwwwwwwww
