wwwwwwwwwwwww
w..........+w
wg..w.w.w...w
w...........w
w.w.....w.w.w
w...........w
w...w..Aw...w
w...........w
wwwwwwwwwwwww
