wwwwwwwwwwwww
w.+.........w
w1..w.......w
wg..........w
ww1.w.w.w..ww
w........A..w
w.w.......w.w
w...........w
wwwwwwwwwwwww
