wwwwwwwwwwwww
w.........3.w
w.w.www.w..+w
w....2......w
wg..w...w...w
w...........w
w.w...wA....w
w...w.......w
wwwwwwwwwwwww
