wwwwwwwwwwwww
w..1..+.....w
w..1w...www.w
wg..........w
w.....w.w...w
w...........w
w.....w.w.w.w
w.........A.w
wwwwwwwwwwwww
