wwwwwwwwwwwww
wwgw3..w.w.ww
ww3w.w.w...ww
ww....3w...ww
www...ww.w.ww
ww.....w.w.ww
ww.w.w.w.w.ww
ww.+.....A.ww
wwwwwwwwwwwww
