wwwwwwwwwwwww
wwwwwwwwwwwww
ww..1....w+ww
ww.......w3ww
ww.....A.w.ww
www..w.w.w.ww
ww.g.1.....ww
wwwwwwwwwwwww
wwwwwwwwwwwww
