wwwwwwwwwwwww
w...........w
w.wA..w...w.w
w.....w...w3w
w.w.www.....w
w.........g.w
w...w...www.w
w.........3+w
wwwwwwwwwwwww
