wwwwwwwwwwwww
w...w.......w
w+w.w..w...ww
w...........w
w.....Aww...w
w.......w...w
w.w.....w.www
w.w.2...wg..w
wwwwwwwwwwwww
