wwwwwwwwwwwww
w...........w
w.........w.w
w........A..w
w.......w.w.w
wg..........w
w1w.w...w...w
w..........+w
wwwwwwwwwwwww
