wwwwwwwwwwwww
w2.........Aw
w.....w.w...w
w...........w
w...w.w.w.w.w
w.+.........w
w...........w
wg..........w
wwwwwwwwwwwww
