wwwwwwwwwwwww
wA..........w
w.w...w.....w
w...........w
w.......w.w.w
w..........1w
w.....w.w.g.w
w......+....w
wwwwwwwwwwwww
