wwwwwwwwwwwww
wg..........w
w.....w.w.w.w
w...........w
w1w.........w
w.........+.w
w.w.........w
w.......A...w
wwwwwwwwwwwww
