wwwwwwwwwwwww
w..........1w
w...w.w...g.w
w...........w
w.w.....w...w
w...........w
wAw.w.......w
w..........+w
wwwwwwwwwwwww
