wwwwwwwwwwwww
wg..........w
w...w.....w.w
w...........w
w2..w.A...w.w
w...........w
w...w...w...w
w..........+w
wwwwwwwwwwwww
