wwwwwwwwwwwww
w.......A...w
w.......w...w
w...........w
w2......w.w.w
w...........w
wgw.........w
w3.........+w
wwwwwwwwwwwww
