wwwwwwwwwwwww
wg.........+w
w...w.....w.w
w...........w
w.w.w.......w
w...........w
w.w.w..A....w
w1..........w
wwwwwwwwwwwww
