wwwwwwwwwwwww
wwwwwwwwwwwww
www.g..2..www
www.....w.www
www.......www
www..Aw...www
www.....+.www
wwwwwwwwwwwww
wwwwwwwwwwwww
