wwwwwwwwwwwww
w.+.........w
w1..w.......w
w.........A.w
w.w.w.w.w.w.w
w..g........w
w.w.......w.w
w3..........w
wwwwwwwwwwwww
