wwwwwwwwwwwww
w...........w
w.w.w.......w
w..A........w
w...w.w...w.w
w...........w
w.....w...w3w
w..+.......gw
wwwwwwwwwwwww
