wwwwwwwwwwwww
w+.3........w
wg......w.w.w
w...........w
w.....w.w.w.w
w...........w
w.....w.w...w
w.........A.w
wwwwwwwwwwwww
