wwwwwwwwwwwww
wg..........w
w.w...w.w...w
w.+2........w
w.w.........w
w...........w
w...........w
w.3.......A.w
wwwwwwwwwwwww
