wwwwwwwwwwwww
w..........gw
w.w.........w
w..........2w
w...w.w.....w
wA..........w
w.w.w.w...w.w
w..........+w
wwwwwwwwwwwww
