wwwwwwwwwwwwwwwwwwwwwwwwwwww
wwwwwwwwwwwwwwwwwwwwwwwwwwww
ww+++++++++wgw++++++++++++ww
w.....-............x-......w
ww++++++++++++++++++++++++ww
w0000===0000000====000000=1w
w0000=00=00====00000===00=1w
w000000=000000=00===0000033w
ww++++++A+++++++++++++++++ww
wwwwwwwwwwwwwwwwwwwwwwwwwwww
wwwwwwwwwwwwwwwwwwwwwwwwwwww
