wwwwwwwwwwwwwwwwwwwwwwwwwwww
wwwwwwwwwwwwwwwwwwwwwwwwwwww
ww+++++++++++wgw+++++++++www
w.......-xx.........x-x...ww
w._l..._.....l___.......l.ww
w....l_l..........l___....ww
ww+++++++++++++++++++++++www
w00000000000===000000====1ww
ww++++++++++A++++++++++++www
wwwwwwwwwwwwwwwwwwwwwwwwwwww
wwwwwwwwwwwwwwwwwwwwwwwwwwww
