wwwwwwwwwwwww
w...........w
w......Aw..ww
w.w.........w
www.w...w.w.w
w...w...w.w2w
wg......w.w.w
w.+1........w
wwwwwwwwwwwww
