wwwwwwwwwwwww
w.........w.w
w.w.....w.w.w
w3.........Aw
w+.ww.w.ww..w
w.3.w.......w
w.wgw.w...w.w
w...........w
wwwwwwwwwwwww
