wwwwwwwwwwwww
w.......3g..w
w.......w..3w
w...........w
www...w.w...w
w...........w
wAw.www...w.w
w..........+w
wwwwwwwwwwwww
