wwwwwwwwwwwww
w..g3.....w+w
w.....w.w.w.w
w...........w
www.....ww..w
w.w...w..A..w
w...www.www.w
w3..........w
wwwwwwwwwwwww
