wwwwwwwwwwwww
w..3.1.....+w
w...ww..w...w
w...........w
www...w.wA..w
w...........w
w.w...w.w.w.w
wg2.........w
wwwwwwwwwwwww
