wwwwwwwwwwwww
w.......w+.3w
w.......w.w.w
w........2..w
w...w.ww...gw
w...........w
wA..w.w.....w
w...w.......w
wwwwwwwwwwwww
