wwwwwwwwwwwww
w.......3.g.w
w.ww.wwww..ww
w...........w
w.w..A....w2w
w.w.w.w...w.w
w.3...w.w.w.w
w...w.....+.w
wwwwwwwwwwwww
