w..2.....w
wpb+pb+b+w
w+p+bbbp+w
w+++b+b++w
w++bpb+++w
w++++p+b+w
w++bpA+++w
w+++b+b++w
w+p+bbbp+w
wpb+pb+b+w
w......1.w
