w..2.....w
w++b++b++w
wb++pp++bw
w++++++++w
wp++++++pw
wpbbA+bbpw
wp+p++p+pw
wb+bbbb+bw
wb+b++b+bw
wp++++++pw
w......1.w
