w......2.w
wbb+bb+bbw
wb+bbbb+bw
w+++bb+++w
w+++bb+++w
wbb++A+bbw
w+++bb+++w
w+++bb+++w
wb+bbbb+bw
wbb+bb+bbw
w..1.....w
