w....2...w
wpp+++p+pw
w+ppp++++w
w+p+pppppw
w++pp+pppw
w++++++++w
w++ppApppw
w+p+pppppw
w+ppp++++w
wpp+++p+pw
w......1.w
