w......2.w
w++++++++w
wp++++++pw
wpp++++ppw
w+pppppp+w
wp+pppp+pw
wpppAppppw
w+p++++p+w
wppppppppw
w++++++++w
w..1.....w
