w....2...w
wb+b+bbb+w
w+b+bb+bbw
wbbbb++++w
wbb++bb++w
w+b+bAb++w
wbb++bb++w
wbbbb++++w
w+b+bb+bbw
wb+b+bbb+w
w....1...w
