w....2...w
wp++pp++pw
wp+p++p+pw
w+p+pp+p+w
w+p+pp+p+w
w+++pA+++w
w+p+pp+p+w
w+p+pp+p+w
wp+p++p+pw
wp++pp++pw
w....1...w
