w....2...w
wb+b++b+bw
wb+bbb+bbw
wb+bb++bbw
wbbb+A+bbw
w++++b+++w
wbbb+++bbw
wb+bb++bbw
wb+bbb+bbw
wb+b++b+bw
w..1.....w
