w....2...w
wp+pppp+pw
wppp++pppw
wpp++++ppw
wp+p+Ap+pw
w++pppp++w
wp++++++pw
w+pp++pp+w
w+pppppp+w
w+p+pp+p+w
w....1...w
