w....2...w
wp++p+p++w
wppp+p++pw
w++p+p+ppw
w+p+pppp+w
wpppp++p+w
w+p+pApp+w
w++p+p+ppw
wppp+p++pw
wp++p+p++w
w..1.....w
