w....2...w
wbbb++bbbw
w+bb++bb+w
wbb++++bbw
wbb++A+bbw
wbb++++bbw
wbb++++bbw
wbb++++bbw
w+bb++bb+w
wbbb++bbbw
w....1...w
