w..2.....w
w+++++b++w
w++b+b+bbw
w+bbbbbbbw
wbbb+++++w
w++++A+b+w
wbbb+++++w
w+bbbbbbbw
w++b+b+bbw
w+++++b++w
w......1.w
