w......2.w
w++++++++w
wppp++pppw
w+pppppp+w
w+ppA+pp+w
wppppppppw
w++++++++w
w++p++p++w
wpp+pp+ppw
wpp+pp+ppw
w..1.....w
