w....2...w
wbp++++pbw
wb+p++p+bw
wp+b++b+pw
wpb++++bpw
wp+p+Ap+pw
wpb++++bpw
wp+b++b+pw
wb+p++p+bw
wbp++++pbw
w..1.....w
