w..2.....w
wp+p++p+pw
wp++++++pw
wb+p++p+bw
w+pbppbp+w
w+++Ab+++w
w+++bb+++w
wp+pppp+pw
wp++++++pw
w+++bb+++w
w......1.w
