w....2...w
wppp++pppw
w+p+pp+p+w
w+p++++p+w
w+++Ap+++w
w++pppp++w
wp+pppp+pw
wp+p++p+pw
w+p+pp+p+w
w+pppppp+w
w....1...w
