wwwwwwwwwwwww
wwwwwwwwwwwww
www......+www
wwwA..w...www
www.......www
www...w..3www
www...g...www
wwwwwwwwwwwww
wwwwwwwwwwwww
