wwwwwwwwwwwww
wwwwwwwwwwwww
www......+www
www.w.....www
www.....g.www
www.....w.www
wwwAw....2www
wwwwwwwwwwwww
wwwwwwwwwwwww
