wwwwwwwwwwwww
w....A......w
w.w.........w
w...........w
wg....w....2w
w...........w
w...w.......w
w.........+.w
wwwwwwwwwwwww
