wwwwwwwwwwwww
w...........w
w...w.....g+w
w...........w
w.w.........w
w...........w
w...w.w.....w
wA..........w
wwwwwwwwwwwww
