wwwwwwwwwwwww
w...........w
w.+.A.....w.w
w...........w
w...w.....w.w
w...........w
w.........w.w
w.........g1w
wwwwwwwwwwwww
