wwwwwwwwwwwww
w.+.........w
w.w.w.....w.w
w...........w
w.w.....w.wAw
w...........w
w.2.........w
wg..........w
wwwwwwwwwwwww
