wwwwwwwwwwwww
ww........Aww
ww.www.w.w.ww
ww2....w...ww
ww+www.wwwwww
ww...w.....ww
www..w.w.wwww
wwg2.2.2...ww
wwwwwwwwwwwww
