wwwwwwwwwwwww
w...........w
w.ww.ww.A.www
w.....w....+w
w.www.w.w.w.w
w1..w...w...w
www.w.www.www
w31g.3......w
wwwwwwwwwwwww
