wwwwwwwwwwwww
ww.......g.ww
ww.wwwww.wwww
ww.....23w.ww
ww.w.w.w1w.ww
ww.w.w.w+3.ww
ww.w.w.w...ww
wwA..w...w.ww
wwwwwwwwwwwww
