wwwwwwwwwwwww
w.w........gw
w.w.www.www.w
w...A.....w.w
w.w.w.wwwww3w
w.w.w.w.3.w2w
www.w.w.www.w
w+..w...2.w.w
wwwwwwwwwwwww
