wwwwwwwwwwwww
wwwwwwwwwwwww
ww2w.......ww
ww3g...www.ww
ww...w.w.+.ww
ww2w.w.w.w.ww
ww...w.w.A.ww
wwwwwwwwwwwww
wwwwwwwwwwwww
