wwwwwwwwwwwww
w.w.w.A.....w
w.w.w.wwwwwww
w...w...w.wgw
www.w.www.w.w
w...w.......w
www.w.wwwwwww
w+.1.....211w
wwwwwwwwwwwww
