wwwwwwwwwwwww
w.w...w.w.wAw
w2www.w.w...w
w.....w.....w
w.w.www.wwwww
w2w.........w
w1wwwww...w.w
wg.3..w.+.w.w
wwwwwwwwwwwww
