wwwwwwwwwwwww
w.w2.3...2.gw
w.www.w.wwwww
w...w.w.w..1w
www.w.w.w.w.w
w+...A....w.w
w.w.w.w.www.w
w...w.....w.w
wwwwwwwwwwwww
