wwwwwwwwwwwww
wwwwwwwwwwwww
w..g22......w
www.w.w.w...w
w1.2w...w.w.w
ww..w.www.www
w+.........Aw
wwwwwwwwwwwww
wwwwwwwwwwwww
