wwwwwwwwwwwww
w2w.w.....w.w
w1w.w1wwwww.w
w.+.......w.w
w.wwwww.wwwAw
w.3...w...w.w
w.w.w.www.w.w
w.wgw...w...w
wwwwwwwwwwwww
