wwwwwwwwwwwww
ww......Aw.ww
wwww.www...ww
ww.13.+....ww
www2ww.w.w.ww
ww.....w...ww
ww.g.w.w.wwww
ww.w1w.....ww
wwwwwwwwwwwww
