wwwwwwwwwwwww
wwwwwwwwwwwww
w.....w...+2w
www.w.www.w.w
w...w.....31w
wAw.w.w...w.w
w.w.....wgw3w
wwwwwwwwwwwww
wwwwwwwwwwwww
