wwwwwwwwwwwww
w...w...w2.1w
w.w.w.www.www
w.....w...g.w
ww.Awww.wwwww
w...w.......w
w.www.www..1w
w+......w1..w
wwwwwwwwwwwww
