wwwwwwwwwwwww
ww.w.A.....ww
ww.www.www.ww
ww.......w.ww
wwww.wwwwwwww
ww......11+ww
wwww.w.w.w.ww
ww.g.32w...ww
wwwwwwwwwwwww
