wwwwwwwwwwwww
wwwwwwwwwwwww
w+..w.....g2w
w3w.1.www.www
w.......w...w
w..ww.www.w.w
w....A......w
wwwwwwwwwwwww
wwwwwwwwwwwww
