wwwwwwwwwwwww
wwwwwwwwwwwww
ww1w.g.w+w.ww
ww3w.w.w.w.ww
ww.........ww
ww1w.w.w.w.ww
ww......Aw.ww
wwwwwwwwwwwww
wwwwwwwwwwwww
