wwwwwwwwwwwww
w.g.3.w2..w.w
w1wwwww.w.w.w
w.....w+w...w
w.w.w2w.www.w
w.....w.....w
w.w.www.w.www
w.w........Aw
wwwwwwwwwwwww
