wwwwwwwwwwwww
wwwwwwwwwwwww
w.w....A....w
w.w.w.www.www
w...w.w.....w
wgw.w.w...www
w2.3....w+31w
wwwwwwwwwwwww
wwwwwwwwwwwww
