wwwwwwwwwwwww
w...w.....w.w
wgw2wwwww...w
w..1w.w.w.w.w
w.w.w.w.w...w
w.......wA..w
wwwww.w.w.w+w
w.33..w.....w
wwwwwwwwwwwww
