wwwwwwwwwwwww
ww.......w+ww
ww.ww..www.ww
ww.A...w.w.ww
wwww.w.w.w.ww
ww...w.w.g3ww
wwww.w...w.ww
ww.....31.2ww
wwwwwwwwwwwww
