wwwwwwwwwwwww
ww......+.1ww
ww.w.w.w.w2ww
ww.w.w.w.w3ww
wwww.wgw.w.ww
wwA......w.ww
wwww.w..ww.ww
ww...w...w2ww
wwwwwwwwwwwww
