wwwwwwwwwwwww
ww.........ww
ww.w.A.wwwwww
ww.w...w...ww
wwww.w.w1w.ww
ww+1.w.w..2ww
ww.www.w..www
ww......2g.ww
wwwwwwwwwwwww
