wwwwwwwwwwwww
w2.+3.w..1..w
www.w.w.www.w
w.w1w.....w.w
w.wwwww.wwwww
w......A....w
wgwww.w.www.w
w.w.......w.w
wwwwwwwwwwwww
