wwwwwwwwwwwww
wwwwwwwwwwwww
ww.w......+ww
ww.w.w.w.1.ww
ww.A......2ww
ww.w.w.www.ww
ww...w..gw1ww
wwwwwwwwwwwww
wwwwwwwwwwwww
