wwwwwwwwwwwww
w..+..w.w.w3w
wwwww.w.w.w.w
w.w...A....2w
w.w.wwwww.w.w
w.......w.w.w
w2www.w.www.w
w.w...w...1gw
wwwwwwwwwwwww
