wwwwwwwwwwwww
wwwwwwwwwwwww
ww.....3.3+ww
ww.w.w.w..2ww
ww.w.w.w..gww
wwAwww.w..www
ww.....w...ww
wwwwwwwwwwwww
wwwwwwwwwwwww
