wwwwwwwwwwwww
wwwwwwwwwwwww
w......+.32.w
w.w.w.w.w.w.w
w...w.w.w.w1w
w.A.w.www.www
w.w.w.w....gw
wwwwwwwwwwwww
wwwwwwwwwwwww
