wwwwwwwwwwwww
wwg..3.....ww
ww.www3w.w.ww
ww.w...w3w.ww
wwww.w.wwwwww
ww...w....+ww
wwww.w.w.wwww
ww...wAw...ww
wwwwwwwwwwwww
