wwwwwwwwwwwww
wAw.....w.w.w
w.w.www.w.w.w
w...w.w.w.w.w
w.w.w.w.w.w.w
w.w.....w.23w
w.w...w.w+w.w
w.w.w.1..1wgw
wwwwwwwwwwwww
