wwwwwwwwwwwww
ww.A.w.....ww
ww.w.w....www
ww.w.......ww
ww.w.w.w.wgww
ww.w.w.1..1ww
ww.w.w.w.w.ww
ww+.1w.w.w2ww
wwwwwwwwwwwww
