wwwwwwwwwwwww
w1+.w.w..2w.w
www.w.w.www.w
w..2......g.w
www.www.w.w.w
w...w...w.w3w
wwwww.w.w.www
w....Aw.w...w
wwwwwwwwwwwww
