wwwwwwwwwwwww
wwwwwwwwwwwww
w...w.wA....w
w.www.w.w..ww
w213....w..2w
w.www.w.www.w
wg..w.w...w+w
wwwwwwwwwwwww
wwwwwwwwwwwww
