wwwwwwwwwwwww
wwwwwwwwwwwww
w.+...w....3w
w.w3w.www.www
w....A....wgw
w.w.w.www.w.w
w.w...w1....w
wwwwwwwwwwwww
wwwwwwwwwwwww
