wwwwwwwwwwwww
wwwwwwwwwwwww
w.wAw...w.w.w
w.w.www.w...w
w....1....2gw
w.w.w...www3w
w+..w...w..3w
wwwwwwwwwwwww
wwwwwwwwwwwww
