wwwwwwwwwwwww
ww...w.w.w.ww
wwgwww.w.w.ww
ww.w.w...A.ww
ww.w.www..www
ww.w...1...ww
ww.w2www.wwww
ww..+.1....ww
wwwwwwwwwwwww
