wwwwwwwwwwwww
w.w.w.w3..wgw
w.....www.w.w
w...A...w...w
wwwwwww.ww.2w
w..........2w
www.www.w...w
w.+.w.1.w...w
wwwwwwwwwwwww
