wwwwwwwwwwwww
ww..1w.g13.ww
ww.w....w.www
ww.w.......ww
wwww.w.ww2www
ww...w.....ww
wwAw.w.w.wwww
ww...w.w.+.ww
wwwwwwwwwwwww
