wwwwwwwwwwwww
w.........3gw
w.w.w.www.w3w
w.w.w...w...w
w...A.wwwwwww
w.w.w.......w
w.www..ww.w.w
w+........21w
wwwwwwwwwwwww
