wwwwwwwwwwwww
wwwwwwwwwwwww
w2w.w..A..w.w
w...www.www.w
w..g..w...w.w
w2w.w.w.www.w
w3w2w......+w
wwwwwwwwwwwww
wwwwwwwwwwwww
