wwwwwwwwwwwww
wwwwwwwwwwwww
w...3.....w+w
w.ww.w..w.w1w
w.w...A...1.w
www.w.w.www.w
wg..w.....w.w
wwwwwwwwwwwww
wwwwwwwwwwwww
