wwwwwwwwwwwww
w.w......A..w
w.w.wwwww.www
w2........w.w
w.w...www.w.w
wgw...w.w...w
w.ww..w.w.w.w
w1w+.2....3.w
wwwwwwwwwwwww
