wwwwwwwwwwwww
w1....w...w+w
w.w.www.www.w
w3.......Aw.w
www.www...w.w
w.1...w.....w
ww..www.wwwww
w2g.w.......w
wwwwwwwwwwwww
