wwwwwwwwwwwww
w..322w.....w
www...w.www.w
w.....wAw.w+w
w.w1w.w.w.w.w
w.g.w.......w
w.w.w.w.wwwww
w.w...w.....w
wwwwwwwwwwwww
