wwwwwwwwwwwww
w1w3+.w.w...w
w.www.w.w.wAw
w...........w
w.w1w.www.www
w.w.3.......w
w.w.wwwww.www
wg..w.......w
wwwwwwwwwwwww
