wwwwwwwwwwwww
wwwwwwwwwwwww
ww.w.w..Aw.ww
ww.w.w.w...ww
ww1........ww
ww12.w.w.w.ww
ww.wgw.w.w+ww
wwwwwwwwwwwww
wwwwwwwwwwwww
