wwwwwwwwwwwww
wwwwwwwwwwwww
ww.g.....2.ww
ww.w.w..ww+ww
ww.w.w.A.w.ww
ww.w.w.www.ww
ww.1.....w1ww
wwwwwwwwwwwww
wwwwwwwwwwwww
