wwwwwwwwwwwww
wwwwwwwwwwwww
w3w...w.....w
w....ww.w2wgw
w.......w...w
w+w.www.www.w
w.w.A.w....3w
wwwwwwwwwwwww
wwwwwwwwwwwww
