wwwwwwwwwwwww
ww3..w3wgw3ww
wwww.w...w.ww
ww.w.w...w.ww
ww.w.w.w.w.ww
ww...A.....ww
www.ww.wwwwww
ww+.......3ww
wwwwwwwwwwwww
