wwwwwwwwwwwww
w.1g........w
w2www.w.ww..w
w.w1..w.w...w
w.www.w.www.w
w.w...wA..w.w
www.w...w.w.w
w+..w...w.1.w
wwwwwwwwwwwww
