wwwwwwwwwwwww
w...w.....g3w
w..ww.wwwwwww
w+......w1..w
w.w.wwwww.www
w.w...w...w.w
w2www.w.www1w
w.w..A......w
wwwwwwwwwwwww
