wwwwwwwwwwwww
wwwwwwwwwwwww
w.....w.w.1gw
www.www.w3w.w
wA.........3w
w..ww.w....ww
w...w......+w
wwwwwwwwwwwww
wwwwwwwwwwwww
