wwwwwwwwwwwww
ww.......1.ww
wwgw.w.w.wwww
ww.w.w.w...ww
ww...w3www.ww
ww1w.w..Aw.ww
wwww.www.w.ww
ww1....w.w+ww
wwwwwwwwwwwww
