wwwwwwwwwwwww
w.w....g.221w
w.wwwwwww.w.w
w.........w.w
w.www.www.w.w
w..A..w.....w
w.wwwww.w.w.w
w...w...w1w+w
wwwwwwwwwwwww
