wwwwwwwwwwwww
wwwwwwwwwwwww
w.w...w2w+wgw
w.w.www.w3w.w
w.w...3..2w.w
wAw.www.w.w.w
w...........w
wwwwwwwwwwwww
wwwwwwwwwwwww
