wwwwwwwwwwwww
w131....w...w
w.www.www.www
w.wgw.w...w.w
w2..w.w.www.w
w..........+w
w.w.w.w.w.www
w.w.w.wAw...w
wwwwwwwwwwwww
