wwwwwwwwwwwww
w32...g.....w
w.w.w3w.wwwww
w.w2w.......w
www.w.w.w.w.w
w.....w.w...w
w.w.w.w.www.w
w+w.w..A..w.w
wwwwwwwwwwwww
