wwwwwwwwwwwww
w+w...w1..w3w
w.w.w.w.www.w
w.w...w.w..gw
w.wwwAw.w.www
w.w.........w
w.w2www.w.w.w
w.3.w...w.w.w
wwwwwwwwwwwww
