wwwwwwwwwwwww
ww1w...w2.gww
ww.w.www...ww
ww.w.w.w.1.ww
ww...w.www.ww
ww........1ww
ww.w.w.w+w.ww
ww.wAw.....ww
wwwwwwwwwwwww
