wwwwwwwwwwwww
wwwwwwwwwwwww
w.w.....w.w.w
wgw.ww....w.w
w.3.w..Aw...w
www..1w.w.w+w
w...1.w.3.w.w
wwwwwwwwwwwww
wwwwwwwwwwwww
