wwwwwwwwwwwww
ww.w.w...3gww
ww.....ww..ww
ww.....w..3ww
ww.w.w.wwwwww
wwA........ww
ww.w.w.www.ww
ww.w..+1.w1ww
wwwwwwwwwwwww
