wwwwwwwwwwwww
wg......3...w
www.w.w.w...w
w.3.w.w.w..+w
wwwwwww.wwwww
w.3....A....w
wwwww...wwwww
w.1...w.....w
wwwwwwwwwwwww
