wwwwwwwwwwwww
w...........w
w1wwwwwwwww.w
w......A....w
w.wwwww.www.w
w+w.w...w..3w
w1w.www.w.www
w3......w.g.w
wwwwwwwwwwwww
