wwwwwwwwwwwww
w.w.w.w.w...w
wg..w.w.w.www
w.w.......2.w
w.wwwA.ww.w.w
w.......w.w.w
wwwww.wwwww2w
w.1.2....+w.w
wwwwwwwwwwwww
