wwwwwwwwwwwww
ww2.gw.....ww
wwww...www.ww
ww3w1......ww
ww.w2wwww..ww
ww...w+....ww
ww.www.w.w.ww
ww.w...w.A.ww
wwwwwwwwwwwww
