wwwwwwwwwwwww
ww......A..ww
ww..ww.wwwwww
ww3..w.....ww
ww.w.w.www.ww
ww.w.w31.w.ww
ww1w.w.www.ww
wwgw.w...w+ww
wwwwwwwwwwwww
