wwwwwwwwwwwww
ww.....w.w+ww
www..www...ww
ww1.21.....ww
wwww.w.ww.www
ww.1.w...A.ww
ww.www.w.w.ww
ww.wg..w...ww
wwwwwwwwwwwww
