wwwwwwwwwwwww
wg23..w.w..2w
wwww..w.w.www
w...........w
wwwww..ww..ww
w.......wA..w
w.www.w.w.w.w
w3w...w.w.w+w
wwwwwwwwwwwww
