wwwwwwwwwwwww
ww.w+3.w...ww
ww3w.www.w.ww
ww..3......ww
wwgw.w.w...ww
ww2w...w...ww
ww...www.wwww
ww...w..A..ww
wwwwwwwwwwwww
