wwwwwwwwwwwww
wwwwwwwwwwwww
ww.....w1.gww
www.ww.w.w.ww
ww.....1.3.ww
ww...w.w.w.ww
ww+.Aw...w.ww
wwwwwwwwwwwww
wwwwwwwwwwwww
