wwwwwwwwwwwww
w12...w.....w
w+www.w.w.www
w.....w.w.w1w
w.w.www.w..3w
w.....A.w...w
w.w.w.w.w.www
w...w.w.w.g.w
wwwwwwwwwwwww
