wwwwwwwwwwwww
ww+....w.w.ww
wwwwww.w.w.ww
ww...A.w...ww
wwwwww.w.w.ww
ww3w.......ww
ww.www.www.ww
ww31...w.2gww
wwwwwwwwwwwww
