wwwwwwwwwwwww
ww.......23ww
ww.www.w.w.ww
ww.w.A...w.ww
wwww.w.w.wwww
wwgw.w.w..+ww
ww1w.www..2ww
ww.........ww
wwwwwwwwwwwww
