wwwwwwwwwwwww
ww.w.2.w.+.ww
ww.....wAwwww
ww.....w.w.ww
ww.www.w.w.ww
ww.w.w...w.ww
wwww2w.w..1ww
ww1g.......ww
wwwwwwwwwwwww
