wwwwwwwwwwwww
ww.g.......ww
ww3w2w.w.w.ww
ww.w2......ww
ww.ww..w.wwww
ww.w.......ww
wwwwww.wwwAww
ww+3.......ww
wwwwwwwwwwwww
