wwwwwwwwwwwww
wwwwwwwwwwwww
ww..A.....2ww
ww.ww..ww..ww
ww.w...w.2+ww
ww.ww..www.ww
ww1w.....g.ww
wwwwwwwwwwwww
wwwwwwwwwwwww
