wwwwwwwwwwwww
wwwwwwwwwwwww
wwg2.......ww
ww3www.www.ww
ww.w...A...ww
ww.www.w.w+ww
ww.w.1...w.ww
wwwwwwwwwwwww
wwwwwwwwwwwww
