wwwwwwwwwwwww
ww.w.w.w.1gww
ww.w.w.w.wwww
ww.......3.ww
ww.wwwww.wwww
ww.....w.31ww
ww.www.w.+www
ww.A.w.w...ww
wwwwwwwwwwwww
