wwwwwwwwwwwww
w.w..1.+..31w
w.w.www.www3w
w.........w.w
w.w.ww..w.www
w.w.w...w.w.w
w.A.w.www...w
w.w.....w..gw
wwwwwwwwwwwww
