wwwwwwwwwwwww
w..Aw.......w
www.wwwww.w.w
w.w.....w...w
w.w.www.w.www
w...w..1w..gw
w.wwww..1.www
w.w...+.31..w
wwwwwwwwwwwww
