wwwwwwwwwwwww
w+....w21.2gw
wwwww.www.www
w.....w.w..3w
w.www.w.w.w.w
w.w.......w.w
w.wwwww.w.www
w....A..w...w
wwwwwwwwwwwww
