wwwwwwwwwwwww
w+w.wA..w.w.w
w.w.w.www.w.w
w.w.......w.w
w.w2wwwww.w.w
w.3.w...1g..w
wwwww.www.w.w
w.1.....w.w.w
wwwwwwwwwwwww
