wwwwwwwwwwwww
ww...w32...ww
wwww.wgw..www
ww.2.......ww
ww.w.w.www.ww
ww.w...w..Aww
ww.....www.ww
ww+w3w.....ww
wwwwwwwwwwwww
