wwwwwwwwwwwww
wwgw.w.w.w.ww
ww+w.w.w.w.ww
ww2........ww
ww3wwwwwwwAww
ww.w.......ww
ww.www.www.ww
ww23.......ww
wwwwwwwwwwwww
