wwwwwwwwwwwww
wwwwwwwwwwwww
w.w.w.+.w.w1w
w.w.www.w2w.w
w.w.w...3..gw
w.w.ww.ww.www
w.A.........w
wwwwwwwwwwwww
wwwwwwwwwwwww
