wwwwwwwwwwwww
wwwwwwwwwwwww
ww...wA..w.ww
ww...www.w.ww
ww2........ww
ww.w...www.ww
ww2g.w.w.3+ww
wwwwwwwwwwwww
wwwwwwwwwwwww
