wwwwwwwwwwwww
ww1......wAww
wwwwww.www.ww
ww.w.......ww
ww3www.w.w.ww
wwg........ww
ww1.+w.w.wwww
ww.w.w..1..ww
wwwwwwwwwwwww
