wwwwwwwwwwwww
w3w.....w.w.w
w.www2www.w.w
wgw3..w.w.w.w
w1w.www.w.w.w
w.w...w..A..w
w.w.www.www.w
w.........w+w
wwwwwwwwwwwww
