wwwwwwwwwwwww
ww.1.....w.ww
wwww.w...wAww
ww...w.w.w.ww
ww+1wwww.w.ww
ww.g2......ww
ww2ww.w.ww.ww
ww.......w.ww
wwwwwwwwwwwww
