wwwwwwwwwwwww
wwwwwwwwwwwww
w...w.wAw.w.w
w.w.w.w.w.w.w
w.w.......w.w
w...www.w.w+w
wg233.w.w.3.w
wwwwwwwwwwwww
wwwwwwwwwwwww
