wwwwwwwwwwwww
w.......w..+w
w3..w.www.www
w.........w.w
wwwwwA..w.w.w
w.....w1....w
wwwwwwwww.www
w2.g......1.w
wwwwwwwwwwwww
