wwwwwwwwwwwww
w..3.......+w
wwwww.....www
w.2.........w
www.www3w.w.w
w.w.w...w.A.w
wg..www.wwwww
w3..........w
wwwwwwwwwwwww
