wwwwwwwwwwwww
ww.....w.1gww
wwww...www3ww
ww.......w.ww
ww.w.www...ww
ww+.A..w...ww
ww.www.w.w.ww
ww......1w1ww
wwwwwwwwwwwww
