wwwwwwwwwwwww
ww1w.......ww
wwgwwwww.w2ww
ww.........ww
wwww1w.www.ww
ww.....w...ww
ww.w.w.w.w.ww
ww...w.A.+.ww
wwwwwwwwwwwww
