wwwwwwwwwwwww
wwwwwwwwwwwww
ww.w.w.w...ww
ww.w.w.ww.Aww
ww..1......ww
ww2w.w2w.w+ww
ww.wgw...w.ww
wwwwwwwwwwwww
wwwwwwwwwwwww
