wwwwwwwwwwwww
ww+w..2w..3ww
ww.www.w.wwww
ww.......w3ww
www.ww.w.w.ww
ww.....w.1gww
wwwwww.w.wwww
wwA........ww
wwwwwwwwwwwww
