wwwwwwwwwwwww
wwg....w213ww
ww.w.www.w+ww
ww.........ww
ww.w...www.ww
ww.w.w...w.ww
ww3www.w.wwww
ww.wA......ww
wwwwwwwwwwwww
