wwwwwwwwwwwww
w.w......+w.w
w1w1wwwww.w.w
w..2........w
w.w..wwww.w.w
w3w.....wA..w
w.w.ww.ww.www
w.g.........w
wwwwwwwwwwwww
