wwwwwwwwwwwww
wgw3w2w.w...w
w.w.w.w.w.www
w...........w
www.w.w.w.w.w
w.3.w.w.w.w.w
w.w.w.wA..www
w.w1w.w....+w
wwwwwwwwwwwww
