wwwwwwwwwwwww
wwwwwwwwwwwww
ww..+.1....ww
www..w2w3w.ww
ww...A...w.ww
ww.w.w.w.w.ww
ww.w...w..gww
wwwwwwwwwwwww
wwwwwwwwwwwww
