wwwwwwwwwwwww
ww.w.......ww
ww.w.wwAw.www
ww1g.w.....ww
ww.w.w.ww..ww
ww.w.w.....ww
ww.w.w.wwwwww
ww.w...+2.2ww
wwwwwwwwwwwww
