wwwwwwwwwwwww
w+....w.w.w.w
w.w.www.w.wAw
w.w.........w
w2w.wwwwwwwww
w.1..1....w.w
w.wgwww.www.w
w2w...w.....w
wwwwwwwwwwwww
