wwwwwwwwwwwww
w.........g1w
w.w.w.www.w3w
w.w...w.w.2.w
w.www.w.w2w.w
w.........w.w
w.+A..wwwwwww
w.w.........w
wwwwwwwwwwwww
