wwwwwwwwwwwww
w...w...1.+2w
w.w.w.www.www
w.w....g.2..w
w.www.w.w..ww
w.w.........w
w.w.www.www.w
wAw.w...w..3w
wwwwwwwwwwwww
