wwwwwwwwwwwww
wwg....1...ww
www..w.w.w.ww
ww.3.w...w.ww
ww.w...w.w.ww
ww.w.....wAww
wwww.www.wwww
ww.1.2.+...ww
wwwwwwwwwwwww
