wwwwwwwwwwwww
wwg+1..w.w.ww
ww.www.w2w.ww
ww3........ww
ww.www.wwwwww
ww.....w...ww
ww.w.1.w.wwww
ww.w......Aww
wwwwwwwwwwwww
