wwwwwwwwwwwww
w1..2.w.2..+w
www.w.w.w.w.w
w...2.......w
w.www.w.wAwww
w.....w.w...w
w.www.www.www
wg..w...w...w
wwwwwwwwwwwww
