wwwwwwwwwwwww
w3......1.+2w
www.wwwwwww3w
w.w.w...w.wgw
w.w.w.w.w.www
w...........w
wwwA..w.w.www
w.....w.....w
wwwwwwwwwwwww
