wwwwwwwwwwwww
w..........+w
wwwww.w.www.w
w3....w...w.w
w.www.wwwAwww
w1w.....w...w
www.www.w.www
wg3...w2w...w
wwwwwwwwwwwww
