wwwwwwwwwwwww
w.1+2.......w
w.w.w.w.w.www
w2.3..w.w...w
wgw...w.www.w
w...w.w.w..Aw
w.www.w.www.w
w...w.......w
wwwwwwwwwwwww
