wwwwwwwwwwwww
wwwwwwwwwwwww
w.w...w.w2.+w
w.ww..w.w.www
wA....w.w...w
w.www.w.w.gww
w.w....2...2w
wwwwwwwwwwwww
wwwwwwwwwwwww
