wwwwwwwwwwwww
w.+...w.w...w
www.w.wAw...w
w.....w.....w
w3w.www...www
w.w.g.w.w...w
w...www.wwwww
w..133......w
wwwwwwwwwwwww
