wwwwwwwwwwwww
ww.w3..w.w.ww
ww.w.www..+ww
ww......A..ww
ww.wwwwww..ww
ww1..w.....ww
wwww.w.w.wwww
wwg3..2....ww
wwwwwwwwwwwww
