wwwwwwwwwwwww
w.......w.1.w
wAw.w.w.ww+.w
w...........w
wwwwwwwww.w.w
w...w..1w.w.w
www.w.w.w...w
w....2w..g.1w
wwwwwwwwwwwww
