wwwwwwwwwwwww
w.w1..w3..g2w
w.www.wwwww.w
w.....w....2w
www.w.www.w.w
w.w.w.....w.w
w.wwwww.w.www
w+....A.w...w
wwwwwwwwwwwww
