wwwwwwwwwwwww
ww2...1w3w.ww
www1ww.w.w+ww
ww.........ww
ww.www.w.wwww
wwAw..gw...ww
wwww...w.w.ww
ww...w.w.w.ww
wwwwwwwwwwwww
