wwwwwwwwwwwww
wwwwwwwwwwwww
w.w.A...w...w
w.www.www.www
w+.......2w.w
w.www.w2www.w
w.w..1w....gw
wwwwwwwwwwwww
wwwwwwwwwwwww
