wwwwwwwwwwwww
ww1g....22.ww
wwwwww.w.wwww
ww2....w.w.ww
ww.w.www.w.ww
ww....A....ww
wwwwwwww.wwww
ww........+ww
wwwwwwwwwwwww
