wwwwwwwwwwwww
ww.+.w.....ww
wwww1www.w.ww
ww21.....w.ww
wwww.wwwwwAww
ww3..w.....ww
ww.w.w.www.ww
ww.wgw.w...ww
wwwwwwwwwwwww
