wwwwwwwwwwwww
ww.....g.1+ww
ww...w..1wwww
ww.....w1w2ww
wwww.w.www.ww
ww...w.....ww
wwwAww.www.ww
ww.....w...ww
wwwwwwwwwwwww
