wwwwwwwwwwwww
ww.+.w.w...ww
wwww.w.w2w.ww
ww..3..w.w.ww
wwww.www.w.ww
ww.w.w....Aww
ww3w.w..w..ww
ww..g.1....ww
wwwwwwwwwwwww
