wwwwwwwwwwwww
wwwwwwwwwwwww
w..2.......+w
w.w.www....ww
w3w.....wA..w
www1.ww.w.www
wg....w.....w
wwwwwwwwwwwww
wwwwwwwwwwwww
