wwwwwwwwwwwww
ww3g.......ww
wwww.w.w.wwww
ww...w..2..ww
wwww2www..www
ww1........ww
ww.www.w.A.ww
ww.w...w+..ww
wwwwwwwwwwwww
