wwwwwwwwwwwww
wwwwwwwwwwwww
w+1.......w.w
www1..w.wwwAw
w.3.w.w.....w
www.w.....w.w
w..gw.w.w.w.w
wwwwwwwwwwwww
wwwwwwwwwwwww
