wwwwwwwwwwwww
ww......1g+ww
ww.w1wwwww2ww
ww.w.....w.ww
ww.wwwwwww.ww
wwA........ww
ww.w.w.www.ww
ww.w.w...w.ww
wwwwwwwwwwwww
