wwwwwwwwwwwww
w.........+.w
www.www.w3www
w...w...wg3.w
w.www.w.w.w.w
w.w.A.w.w.w.w
wwwww.w1w.www
w.....w.w..2w
wwwwwwwwwwwww
