wwwwwwwwwwwww
ww.w.w.w1.3ww
ww.w2w.www+ww
ww.2.......ww
ww.www.w.wwww
ww....A....ww
wwgwwwwwwwwww
ww.........ww
wwwwwwwwwwwww
