wwwwwwwwwwwww
w.w.......w3w
w+w.w.w.w.w.w
w.A.w.w...w.w
wwwwwww.www3w
w.w...w2w...w
w.www.w.w.www
w....2.....gw
wwwwwwwwwwwww
