wwwwwwwwwwwww
w.2...w.w1.+w
w.www.w.w.www
w..3.......2w
w.www.wAwww.w
w.w...w.w.w.w
w.w.w.w.w.w.w
w.wgw.....w.w
wwwwwwwwwwwww
