wwwwwwwwwwwww
w.....3...w+w
www.wwwwwww.w
w3....w....Aw
w.wwwww.wwwww
w.g.........w
w.w..www..www
w3w.3.......w
wwwwwwwwwwwww
