wwwwwwwwwwwww
w.......w.3.w
w.w.wwwww.www
w..A......w.w
w...wwwww.w.w
w+..w...w...w
www...www3w.w
w.2..1.....gw
wwwwwwwwwwwww
