wwwwwwwwwwwww
wwwwwwwwwwwww
ww1w.w1..w+ww
ww.w2w.w.w.ww
wwg........ww
ww.www.www.ww
ww...w...A.ww
wwwwwwwwwwwww
wwwwwwwwwwwww
