wwwwwwwwwwwww
ww.w.wgw.w2ww
ww1w.w.w.w.ww
ww...w.w.w3ww
wwww.w.w.w.ww
ww...wA....ww
ww...w.w.w.ww
ww+.2..w.w.ww
wwwwwwwwwwwww
