wwwwwwwwwwwww
wwg.3.....2ww
wwww.w.w.w.ww
ww...w.w.w.ww
wwww.www.w.ww
ww2....A...ww
ww2ww..w.w.ww
ww.....w.w+ww
wwwwwwwwwwwww
