wwwwwwwwwwwww
ww.w...w.w.ww
ww.w.www.w.ww
ww.A.w...w3ww
ww...w.2gw.ww
ww1..w.3.w.ww
ww.w.w.www.ww
ww+........ww
wwwwwwwwwwwww
