wwwwwwwwwwwww
ww.w......gww
ww.www.wwwwww
ww.....wA..ww
wwwwww.w.wwww
ww111....w.ww
ww.www.w.w.ww
ww.2.+.....ww
wwwwwwwwwwwww
