wwwwwwwwwwwww
w.........A.w
w.www.wwwwwww
w.w.........w
www.www.w.www
w.1...w.w...w
w2gww.wwwwwww
w1..w.2....+w
wwwwwwwwwwwww
