wwwwwwwwwwwww
w.w3w...w...w
w+w.www.www.w
w.w.w.......w
w.w.ww3ww.www
w1..w...w.A.w
www.ww..w.w.w
wg.3........w
wwwwwwwwwwwww
