wwwwwwwwwwwww
wg2.w.....w.w
www.w.wwwww.w
w.w...w...wAw
w.www.w...w.w
w.w...w.....w
w1www.w.w.www
w3.2....+...w
wwwwwwwwwwwww
