wwwwwwwwwwwww
w.w.....wg.1w
w.www.wwwww.w
w...w.w.w.+1w
www.w.w1www.w
w...........w
wAw.w.www.w.w
w...w...w.w2w
wwwwwwwwwwwww
