wwwwwwwwwwwww
wwwwwwwwwwwww
ww1w1.+w...ww
ww.w...www.ww
ww.g.......ww
www..www.w.ww
ww2..w....Aww
wwwwwwwwwwwww
wwwwwwwwwwwww
