wwwwwwwwwwwww
wwg1.......ww
ww1..ww.ww.ww
ww........Aww
wwwwww.wwwwww
ww...w.w..+ww
ww.w.w.w.wwww
ww2..3.....ww
wwwwwwwwwwwww
