wwwwwwwwwwwww
ww..Aw.....ww
wwww...wwwwww
ww.........ww
ww.ww..w..1ww
ww3w2......ww
ww.www.w.wwww
ww+w.....1gww
wwwwwwwwwwwww
