wwwwwwwwwwwww
ww.21.g..2.ww
www.w..ww+www
ww.....2...ww
wwww.w....www
ww...w.w...ww
wwww.w.w.w.ww
wwA..w.w...ww
wwwwwwwwwwwww
