wwwwwwwwwwwww
ww2....w.w.ww
ww.www.w..Aww
ww.........ww
ww.w.w3wwwwww
ww.w.g.w.w.ww
ww2ww....w.ww
ww+2.......ww
wwwwwwwwwwwww
