wwwwwwwwwwwww
wwwwwwwwwwwww
ww.g..2..w3ww
ww1w.www...ww
ww...w.w..+ww
ww.www.w..www
ww.w...A...ww
wwwwwwwwwwwww
wwwwwwwwwwwww
