wwwwwwwwwwwww
ww.w..2w..gww
ww.w.www.wwww
ww.....w2.1ww
ww.wwwww.w.ww
wwA......w.ww
ww.w.w.w1w.ww
ww.w......+ww
wwwwwwwwwwwww
