wwwwwwwwwwwww
ww2w.w.w1w.ww
ww1w+w.w.w.ww
ww3....w.wgww
www..w.w.w.ww
ww.......w.ww
ww.www.....ww
ww.w...A...ww
wwwwwwwwwwwww
