wwwwwwwwwwwww
ww.....3.w2ww
wwww.w3w.w.ww
ww.w.....2+ww
wwgw.www.wwww
ww.....w...ww
ww.w.w.w.w.ww
ww...A.w...ww
wwwwwwwwwwwww
