wwwwwwwwwwwww
ww.w......+ww
ww.w.w.wwwwww
ww...A...w.ww
wwww.w...w1ww
ww.....w...ww
ww.wg..w.w.ww
ww.w.w2..21ww
wwwwwwwwwwwww
