wwwwwwwwwwwww
ww+w1w...w.ww
ww.w.www.w.ww
ww...w.w..2ww
wwww.w.w.w.ww
ww.w.wA....ww
ww...w.w.w2ww
ww3....w.g.ww
wwwwwwwwwwwww
