wwwwwwwwwwwww
wwwwwwwwwwwww
ww3..w.wg..ww
ww.www.w.w.ww
ww1...A....ww
ww.www.w.w.ww
ww+....w.w1ww
wwwwwwwwwwwww
wwwwwwwwwwwww
