wwwwwwwwwwwww
wwwwwwwwwwwww
w....A.....+w
w.w.w.w.www.w
w.w.w.w.w..1w
w.w.www.w.w1w
wg.......3w3w
wwwwwwwwwwwww
wwwwwwwwwwwww
