wwwwwwwwwwwww
ww......2..ww
wwwwww.w...ww
ww.wA....w.ww
ww.w.w.....ww
ww...w.w13.ww
wwwwww.w3wwww
ww.+......gww
wwwwwwwwwwwww
