wwwwwwwwwwwww
w1w3....w.w+w
w1www.www.w.w
wg..3.......w
w.wwwww.w.w.w
w.....w.w.w.w
w.w.wwwww.www
w.....w..A..w
wwwwwwwwwwwww
