wwwwwwwwwwwww
w..A....w..1w
wwww..www.www
w.....w.w..1w
wwwww.w.w.www
w.........g+w
w.w.w.www.www
w.w.w.3.w..3w
wwwwwwwwwwwww
