wwwwwwwwwwwww
ww3w...w...ww
ww.www...3www
ww...A.....ww
ww.www.wwwwww
ww+........ww
wwww.w.wgw.ww
ww3....w.w2ww
wwwwwwwwwwwww
