wwwwwwwwwwwww
wwwwwwwwwwwww
w1.........Aw
w.www.www.www
w.w.w.w...w.w
wgw.www.w.w.w
w12.....w.+.w
wwwwwwwwwwwww
wwwwwwwwwwwww
