wwwwwwwwwwwww
ww...1.g.w.ww
wwwwww.www.ww
ww.w..3..w2ww
ww.w.w.www.ww
ww..A..w2w.ww
wwww.w.w.w.ww
ww......+..ww
wwwwwwwwwwwww
