wwwwwwwwwwwww
ww...w.g..+ww
ww.www.wwwwww
ww.....w.w3ww
wwwwww.w.w.ww
ww...w23...ww
wwAwww.www2ww
ww.......w.ww
wwwwwwwwwwwww
