wwwwwwwwwwwww
ww...w.w12gww
ww.w.w.w1wwww
ww.w.w....1ww
ww.w.w.wwwwww
ww+........ww
ww.w.w.w.w.ww
ww.wAw.w.w.ww
wwwwwwwwwwwww
