wwwwwwwwwwwww
ww.w.wAw..3ww
ww.w.w.www.ww
ww...w.....ww
www..w.w.w.ww
ww.3....+..ww
wwgw.w.w.w.ww
ww2w.w.w.w.ww
wwwwwwwwwwwww
