wwwwwwwwwwwww
w...2.w.2.w3w
wwwww.w.w.w.w
wg......w.3+w
www.www.w.www
w.....w...w.w
www.w.www.w.w
w...wAw.....w
wwwwwwwwwwwww
