wwwwwwwwwwwww
ww.g.....w.ww
wwww.www.w.ww
ww2w.2.w...ww
ww...www..www
ww......A.1ww
ww.w.w.ww..ww
ww+w.......ww
wwwwwwwwwwwww
