wwwwwwwwwwwww
w..2..3.....w
w.www.www.w+w
w3..w...w.w.w
w.w.www.w.www
w.w...w....2w
wgw.w.A.w..ww
w...w.w.....w
wwwwwwwwwwwww
