wwwwwwwwwwwww
w+w.w.w...w.w
w.w.w.www.w.w
w..........Aw
wwg.ww.w..w.w
w33.......w.w
w.wwwww.w.w.w
w2w2....w.w.w
wwwwwwwwwwwww
