wwwwwwwwwwwww
w.w...+.w..Aw
w.w.w.www.w.w
w.22..w.....w
wwwww.www.www
w..3........w
w.g.www.w.www
w2w.w...w...w
wwwwwwwwwwwww
