wwwwwwwwwwwww
wwgw1w.w...ww
ww2w.w.ww..ww
ww3..w.....ww
ww.w3w.wwwAww
ww...w.w.w.ww
wwww.w.w.wwww
ww.+.......ww
wwwwwwwwwwwww
