wwwwwwwwwwwww
w.w.w...w..1w
w+w.w.www.w.w
w.w2.....gw1w
w.w.wwwwwww3w
w.....w...w.w
w.w.www.wwwww
w.w..A......w
wwwwwwwwwwwww
