wwwwwwwwwwwww
wwgw...w...ww
ww2w.w.w.w.ww
ww.........ww
wwwwww.wwwwww
ww.1.w.....ww
www1.w.wwA.ww
ww.1.....+.ww
wwwwwwwwwwwww
