wwwwwwwwwwwww
wwwwwwwwwwwww
w.w.....13g2w
w.ww.ww.www1w
w...........w
w.w.www.w.w.w
wAw........+w
wwwwwwwwwwwww
wwwwwwwwwwwww
