wwwwwwwwwwwww
w+w.1.w..3..w
w.www.w.www.w
w.......w...w
wwwww.wAwww.w
w...w.w.w...w
www3w.w.wwwgw
w2....w...w.w
wwwwwwwwwwwww
