wwwwwwwwwwwww
wwwwwwwwwwwww
ww2.......gww
ww3w.wAwww.ww
ww.w...w...ww
ww.w2w.w..www
ww..+w.w...ww
wwwwwwwwwwwww
wwwwwwwwwwwww
