wwwwwwwwwwwww
wwwwwwwwwwwww
w.....w.w.w.w
w..ww.w.w.2gw
w..........2w
w.wAwww.w...w
w+w.w...w.w1w
wwwwwwwwwwwww
wwwwwwwwwwwww
