wwwwwwwwwwwww
w...w....+..w
w...w.www..1w
w.w.....w...w
wAwwwww.wwwww
w.....w...1.w
w.w.wwwww.www
w...g...w.31w
wwwwwwwwwwwww
