wwwwwwwwwwwww
wgw..3......w
w.w.w.www.www
w2.2w.w.w.w.w
w..1www.www.w
w.........w+w
w.www.w.www.w
w.w...w..A..w
wwwwwwwwwwwww
