wwwwwwwwwwwww
wwgw..1w...ww
ww.www.w.w.ww
ww.......w.ww
wwww2w+w.wwww
ww.....w...ww
ww...w.w..Aww
ww11...w...ww
wwwwwwwwwwwww
