wwwwwwwwwwwww
ww3g.3.w...ww
ww..2w.www.ww
ww+w.......ww
wwww.w.w.w.ww
ww...w.w.w.ww
wwww.w.wwwAww
ww.3.w.w...ww
wwwwwwwwwwwww
