wwwwwwwwwwwww
ww..3w...1.ww
wwww...wwwwww
ww2w.wAw.w.ww
ww...w.w.w.ww
ww+..w.....ww
ww3w.w.w...ww
ww....gw.w.ww
wwwwwwwwwwwww
