wwwwwwwwwwwww
w.....w31..gw
w.www.w.wwwww
w.w...1.w..2w
w.w.www.w.www
wAw.w.......w
wwwww...wwwww
w.+...w.....w
wwwwwwwwwwwww
