wwwwwwwwwwwww
wwwwwwwwwwwww
ww..Aw.....ww
ww.w.w.ww3.ww
ww...w...1+ww
www....wgw1ww
ww.....w.w.ww
wwwwwwwwwwwww
wwwwwwwwwwwww
