wwwwwwwwwwwww
w.....w...wgw
w.w.www.www3w
w.w.........w
wAw.w.w.w.w1w
w.w.w.w.w.w.w
w.www.wwwwwww
w....+...2.3w
wwwwwwwwwwwww
