wwwwwwwwwwwww
w.w.w3..w.wgw
w.w.w.w...w2w
w.....w.w..1w
w.www.www.www
w.........2.w
w+www.wwwwwww
w..A........w
wwwwwwwwwwwww
