wwwwwwwwwwwww
wwwwwwwwwwwww
ww.w....2.gww
ww.www.1.w1ww
ww.A...w.w.ww
www....w...ww
ww+....w.w.ww
wwwwwwwwwwwww
wwwwwwwwwwwww
