wwwwwwwwwwwww
w..1w..2..w.w
w.www.www.wgw
w+w.....w...w
w.www.wwwww.w
w...w.w.w..2w
www.wAw.w.w.w
w.........w1w
wwwwwwwwwwwww
