wwwwwwwwwwwww
ww.+......3ww
www..www1w.ww
ww1....w.w.ww
ww.wAw.w.w.ww
ww.w.w.w...ww
wwwwww.www3ww
ww........gww
wwwwwwwwwwwww
