wwwwwwwwwwwww
w1w..A......w
w.w.www.w..ww
w...w.w.....w
w.www.www1www
w.......w...w
w.w.www.w1www
w+.....2w.g.w
wwwwwwwwwwwww
