wwwwwwwwwwwww
wwwwwwwwwwwww
wg....1...w.w
www.w.w.www.w
w1w...w....+w
w1w1w.w.www.w
w.........A.w
wwwwwwwwwwwww
wwwwwwwwwwwww
