wwwwwwwwwwwww
w.w.......13w
w...www.w.wgw
w.....w..1..w
w.www.www.www
w.w.A.....w.w
w+w.ww..www.w
w2..........w
wwwwwwwwwwwww
