wwwwwwwwwwwww
wwwwwwwwwwwww
w+1.....1...w
w.w..Aw.w.www
w.w...w.w...w
www.w.w.www.w
w1.......2.gw
wwwwwwwwwwwww
wwwwwwwwwwwww
