wwwwwwwwwwwww
ww.3......3ww
wwwwww.wwwwww
wwgw...w.w.ww
ww.www.w.w.ww
ww3........ww
www.ww.w...ww
ww....Aw.w+ww
wwwwwwwwwwwww
