wwwwwwwwwwwww
wwwwwwwwwwwww
ww.w...w.w1ww
wwAw.w.w.w.ww
ww.w...w11.ww
ww...www..gww
ww.....+...ww
wwwwwwwwwwwww
wwwwwwwwwwwww
