wwwwwwwwwwwww
w..+1.w1w.w3w
w2www.w.wgw.w
w...........w
w.w.w.www.w.w
w.......w...w
w.w.w.w.w.w.w
w.....A.w.w.w
wwwwwwwwwwwww
