wwwwwwwwwwwww
w.1..3w.w...w
wgwww1w.w.www
w.w.........w
w.w.www.w.www
w...w.w.+...w
w1w.w.w.w...w
w.w.w...w.wAw
wwwwwwwwwwwww
