wwwwwwwwwwwww
wwwwwwwwwwwww
w..+....w1..w
www..ww.w.www
w..A....w.w3w
w.www.w.w.wgw
w........2..w
wwwwwwwwwwwww
wwwwwwwwwwwww
