wwwwwwwwwwwww
w...w...w1.gw
wAwwww..w...w
w.......w.w.w
wwwww.www.www
w..........3w
w.www.w.ww.ww
w....3w2.+..w
wwwwwwwwwwwww
