wwwwwwwwwwwww
w.....w3..2gw
wwwww...wwwww
w...w.......w
w.w.www.wwwww
w...w.w...2.w
w.w.w.w.www1w
w+w.A.......w
wwwwwwwwwwwww
