wwwwwwwwwwwww
w.w.w...w...w
w.w.wwwAw.w.w
w...........w
w.www.www.www
w1...2..w.1+w
w.w3w.wwwww.w
w.wgw.w.....w
wwwwwwwwwwwww
