wwwwwwwwwwwww
ww.w.A...w.ww
ww.www.....ww
ww........1ww
wwwwww.www2ww
ww+w.....w.ww
ww.www.w.w.ww
ww33...w.wgww
wwwwwwwwwwwww
