wwwwwwwwwwwww
w.w....1w...w
w.w.w.w.w..ww
w...w.A...32w
ww..wwwww.w.w
w..2........w
www.ww.wwww.w
wg.........+w
wwwwwwwwwwwww
