wwwwwwwwwwwww
ww....A....ww
ww.w.wwwwwwww
ww.w.....g.ww
wwww.w.w.w1ww
ww..3w.w.w.ww
ww3w.w.w.w.ww
ww.+2w.w.w.ww
wwwwwwwwwwwww
