wwwwwwwwwwwww
w3w...w.w.1gw
w3w..ww.w.w1w
w...........w
www.w.wwwwwww
w+..w.......w
wwwwwww.w.www
w....A......w
wwwwwwwwwwwww
