wwwwwwwwwwwww
wwwwwwwwwwwww
w2......w..+w
w.www.w.w.w.w
w1w.2.w.w...w
www.w.w.A.www
wg.3w.......w
wwwwwwwwwwwww
wwwwwwwwwwwww
