wwwwwwwwwwwww
wwg1.2.....ww
ww.w.www.w.ww
ww.w...w.w.ww
ww.www.www.ww
ww2......A.ww
ww.w.w.wwwwww
ww1+.w.....ww
wwwwwwwwwwwww
