wwwwwwwwwwwww
w...A.w...w.w
wwwww.wwwgw2w
w.......w...w
ww.ww.www.www
w...........w
w1w.w.www.www
w.w+w....1.2w
wwwwwwwwwwwww
