wwwwwwwwwwwww
wgw..2w.w.w.w
w.www.w.w.w.w
w........3..w
www.wwwwwwwww
w...2...w..2w
www.w.www.w.w
w...w.A...w+w
wwwwwwwwwwwww
