wwwwwwwwwwwww
w.w.w.w.1gw2w
w.w.w.w.w.w3w
w.......w.w1w
www...www.w.w
w.....+.....w
w.wAw.wwwwwww
w...........w
wwwwwwwwwwwww
