wwwwwwwwwwwww
wwwwwwwwwwwww
w.w.w.w.w3g.w
w.w.w.w.w.www
w.w...w...2.w
wAwww.w.www2w
w........2.+w
wwwwwwwwwwwww
wwwwwwwwwwwww
