wwwwwwwwwwwww
w.w.w.....A.w
w.w.www.w.www
w.w.....w.w.w
w.wwwww.w+w.w
w21.w.....w.w
wwwgwww.www.w
w2..1.......w
wwwwwwwwwwwww
