wwwwwwwwwwwww
wgw...w.w...w
w3www.w.w..ww
w2w...w.w.+.w
w.ww1.w.w.www
w..1........w
w.w.w.www.w.w
w...w....Aw.w
wwwwwwwwwwwww
