wwwwwwwwwwwww
ww2......+.ww
ww.w.wA..w.ww
ww.w.w.w.w.ww
wwww.wwwww2ww
ww...w.....ww
ww.wgw.w.wwww
ww3w...w..2ww
wwwwwwwwwwwww
