wwwwwwwwwwwww
ww3..w.w...ww
ww.w.w.w.w.ww
ww.....A.wgww
ww.w.w.w...ww
ww.w.w.w...ww
wwww.wwww.www
ww2+..3..3.ww
wwwwwwwwwwwww
