wwwwwwwwwwwww
ww.w.....w+ww
ww.www1www.ww
ww.........ww
wwAwwwwwww3ww
ww.....w..1ww
ww.wwwgwww.ww
ww...w.w...ww
wwwwwwwwwwwww
