wwwwwwwwwwwww
ww+w.2...w.ww
ww.www.www.ww
ww.w2g.....ww
ww.w.w.www.ww
ww3w.w...w3ww
ww.www.w.wwww
ww.....w.A.ww
wwwwwwwwwwwww
