wwwwwwwwwwwww
ww.2..gw...ww
wwww.www..www
ww.w.....31ww
ww3w.wwwwwwww
ww.........ww
ww...www..www
ww.w..A...+ww
wwwwwwwwwwwww
