wwwwwwwwwwwww
w.....w.w...w
wAwwwww.w.2.w
w...w...w.w3w
w.www.w.w..gw
w.w.w..2w..3w
w.w...www.w.w
w....+......w
wwwwwwwwwwwww
