wwwwwwwwwwwww
wwwwwwwwwwwww
w.1.........w
w3w3..www...w
w.w.w.w..gw.w
w1w.www.www.w
w.+...A.w...w
wwwwwwwwwwwww
wwwwwwwwwwwww
