wwwwwwwwwwwww
w.w.w...w..1w
w...www3w+w.w
wAw...w...w.w
w.w.www.wwwww
w.w....2..w.w
w.wwwww.w.w.w
w......1w..gw
wwwwwwwwwwwww
