wwwwwwwwwwwww
wwwwwwwwwwwww
w...w.....wAw
ww..www.www.w
w2..........w
w.w.....w.www
w+.1g3w.w...w
wwwwwwwwwwwww
wwwwwwwwwwwww
