wwwwwwwwwwwww
wwwwwwwwwwwww
w.w2w.w...g.w
w+w.w...w.w.w
w...w.....2.w
www.wA.www.ww
w.........3.w
wwwwwwwwwwwww
wwwwwwwwwwwww
