wwwwwwwwwwwww
w.3.....w...w
w.w2wwwwwwwgw
w.w....A..w.w
w2..w.w.w.w.w
w.w.w.......w
w.w...wwwww.w
w+w.w.....w2w
wwwwwwwwwwwww
