wwwwwwwwwwwww
w......gw.1.w
w+ww..www2www
w.w.........w
www.w.www.w3w
w...w...w.w.w
wwwww.w.www.w
w..A..w....3w
wwwwwwwwwwwww
