wwwwwwwwwwwww
wwwwwwwwwwwww
w+.......g.2w
www.w..ww.www
w...w.....2.w
ww....w.www.w
w.A.w...2.w.w
wwwwwwwwwwwww
wwwwwwwwwwwww
