wwwwwwwwwwwww
w+....A.....w
w.ww.wwww.www
w.......w...w
w.wwwwwwwww.w
w...........w
w.3ww.w.www1w
w......g..13w
wwwwwwwwwwwww
