wwwwwwwwwwwww
wwwwwwwwwwwww
ww.1.....+.ww
ww.w.w.w.w2ww
ww.w.wA..w.ww
ww.w.www.w2ww
wwg......w.ww
wwwwwwwwwwwww
wwwwwwwwwwwww
