wwwwwwwwwwwww
w.w.......A.w
w.w.w.w.wwwww
w.w.w2w.w...w
w.w.wwwww.www
wg.....2..w.w
w.w.www.w3w.w
w.w.w2..w..+w
wwwwwwwwwwwww
