wwwwwwwwwwwww
wwwwwwwwwwwww
w.3.w......+w
www1w.www.w.w
w.w3w.A.w.w.w
w2w.w.www.www
w.g.....w...w
wwwwwwwwwwwww
wwwwwwwwwwwww
