wwwwwwwwwwwww
w+..3.......w
www.w.w.w..ww
w.g.w...w...w
www.www.w.www
w...w....A..w
w.w.w.w.w...w
w12..2w.w.w.w
wwwwwwwwwwwww
