wwwwwwwwwwwww
w..A....w...w
wwwww.wwwww3w
w+..........w
w.www.w.w.www
w.w...w....3w
www.www.wwwww
w........3g2w
wwwwwwwwwwwww
