wwwwwwwwwwwww
w...w...w1.1w
w.w.w.www.w3w
w...w.w.w.g.w
w.www.w.w..ww
w.A.....w...w
www.ww..w.www
w...w+...1..w
wwwwwwwwwwwww
