wwwwwwwwwwwww
ww.......+2ww
ww.w.wwwww1ww
ww.....w..2ww
ww....ww.w.ww
wwAw.....w1ww
wwww.www.w.ww
ww.....w.g.ww
wwwwwwwwwwwww
