wwwwwwwwwwwww
wg........w.w
w1ww..w..ww.w
w.w...w....Aw
www2w.www.w.w
w3w.......w.w
w.w.w2+...w.w
w...w.w...w.w
wwwwwwwwwwwww
