wwwwwwwwwwwww
wwwwwwwwwwwww
w.w.wAw.w...w
w.w...w.ww..w
w+..........w
www...www.wgw
w..3w.w..2.1w
wwwwwwwwwwwww
wwwwwwwwwwwww
