wwwwwwwwwwwww
ww.....w.w.ww
ww.w.w....2ww
ww.w.....2gww
ww.www.w.w.ww
ww.A.w.w.w.ww
wwww.w.w.wwww
ww+....w..3ww
wwwwwwwwwwwww
