wwwwwwwwwwwww
w...wgw.....w
w.w.w..2w.www
w.....w.w.1+w
www.www.w.w3w
w.w.w.w.w.w1w
w..Aw.w.www.w
w.........w.w
wwwwwwwwwwwww
