wwwwwwwwwwwww
w+.......31.w
www...w.w2wgw
w...w3w.....w
w.w.www.wwwww
w.w...w.....w
w.w.w.w.w.www
w.w.A.w.....w
wwwwwwwwwwwww
