wwwwwwwwwwwww
wwg..w....2ww
ww3www.w.w.ww
ww..1w.....ww
ww.w.wAw.wwww
ww.w.......ww
ww.w.www.w.ww
ww3......+.ww
wwwwwwwwwwwww
