wwwwwwwwwwwww
w....3..22..w
www.www..wwww
w.....w.....w
wAw.wwww..www
w.w...w..g..w
w.www.w.www3w
w+..w.......w
wwwwwwwwwwwww
