wwwwwwwwwwwww
ww.w.w.A...ww
ww.w.www.w.ww
ww.w...2.w.ww
ww.www.w.wwww
ww.3...w...ww
ww1w.w.w.wwww
ww2wgw....+ww
wwwwwwwwwwwww
