wwwwwwwwwwwww
ww+....w.32ww
wwww.www.w1ww
ww3.......gww
ww...w.www.ww
ww....A....ww
wwww.w...wwww
ww...w.w...ww
wwwwwwwwwwwww
