wwwwwwwwwwwww
wwwwwwwwwwwww
wgw....2w.w.w
w.w.w.www3..w
w.........w1w
w.ww.ww.w.w+w
w....Aw.....w
wwwwwwwwwwwww
wwwwwwwwwwwww
