wwwwwwwwwwwww
wwwwwwwwwwwww
w....A......w
www.w.w.www1w
w+w.w.w...w.w
w...www.w.wgw
w1....w.w.12w
wwwwwwwwwwwww
wwwwwwwwwwwww
