wwwwwwwwwwwww
ww.2.w...w.ww
wwww3www.w+ww
ww.w.w...w.ww
ww2w.www.w.ww
wwg....w...ww
wwww.w.w.w.ww
ww...w..A..ww
wwwwwwwwwwwww
