wwwwwwwwwwwww
wwwwwwwwwwwww
w2w3..w.w.w+w
w.w.www.w.w.w
w2w.w...w...w
wgw.w.wAw.w.w
w.....w.....w
wwwwwwwwwwwww
wwwwwwwwwwwww
