wwwwwwwwwwwww
wwwwwwwwwwwww
wg21w2......w
www...www.w.w
w..........+w
www.w.....w.w
w...w.w..Aw.w
wwwwwwwwwwwww
wwwwwwwwwwwww
