wwwwwwwwwwwww
wwwwwwwwwwwww
w+w3w.11w.w.w
w.w.w.w...w.w
w.....w...w.w
w.www.w.w.wgw
w.A.w.w.w...w
wwwwwwwwwwwww
wwwwwwwwwwwww
