wwwwwwwwwwwww
ww.1.w...w.ww
wwww2w.w.w+ww
ww.w...w.A.ww
ww...w.w...ww
ww.....w...ww
ww3www2www.ww
wwgw.......ww
wwwwwwwwwwwww
