wwwwwwwwwwwww
w.....w.w.33w
www.w.w.w1www
w.w.....wgw.w
w.www.www.w.w
w..Aw...w...w
w.w.www.w.w.w
w.....+....3w
wwwwwwwwwwwww
