wwwwwwwwwwwww
ww.........ww
wwwwww+w.w3ww
ww......1w3ww
wwAwww.www.ww
ww...w...w.ww
wwwwww.wwwwww
ww...1..g..ww
wwwwwwwwwwwww
