wwwwwwwwwwwww
wwwwwwwwwwwww
wgw...w.w.w.w
w.www.w.w.w.w
w.23..w.A...w
w.www.w.w..ww
w1w.1...w..+w
wwwwwwwwwwwww
wwwwwwwwwwwww
