wwwwwwwwwwwww
w.....22...3w
www.w.w.w.wgw
w...w.w.w..3w
w...wwwww.www
w.w+......w.w
www.w.wwwww.w
wA..w.......w
wwwwwwwwwwwww
