wwwwwwwwwwwww
ww........1ww
ww.w..ww.wwww
ww....A..12ww
ww.wwwwwww.ww
ww...w.w...ww
ww.www.w.w+ww
ww..g....3.ww
wwwwwwwwwwwww
