wwwwwwwwwwwww
w...w.w...wgw
www.w.www.w.w
w+w.w.w.w3..w
w2w.w.w.w..ww
w.........2.w
w.www...w...w
w...wA..w.1.w
wwwwwwwwwwwww
