wwwwwwwwwwwww
wwwwwwwwwwwww
wg32..w....+w
w2w.w.www.www
w.w.w.......w
w2..www.www.w
w.......A.w.w
wwwwwwwwwwwww
wwwwwwwwwwwww
