wwwwwwwwwwwwwwwwwwwwwwwwwwww
wwwwwwwwwwwwwwwwwwwwwwwwwwww
w++++++++++++wgw++++++++++ww
0=0000000===0000000000000=1w
w+++++++++++++++++++++++++ww
..__.......l_l_......____..w
....ll__....._l_......_ll..w
w+++++++++++++++++++++++++ww
w+++++++++A+++++++++++++++ww
wwwwwwwwwwwwwwwwwwwwwwwwwwww
wwwwwwwwwwwwwwwwwwwwwwwwwwww
