wwwwwwwwwwwwwwwwwwwwwwwwwwww
w++++++++wgw++++++++++++++ww
000000==000000=0000=0000==3w
0000000====00000000==000031w
00===00000==0000=00=0000031w
000000000000====000000000=1w
w+++++++++++++++++++++++++ww
00====00000=000==00000==0=3w
w++++++++++++++++++++++A++ww
wwwwwwwwwwwwwwwwwwwwwwwwwwww
wwwwwwwwwwwwwwwwwwwwwwwwwwww
