wwwwwwwwwwwwwwwwwwwwwwwwwwww
wwwwwwwwwwwwwwwwwwwwwwwwwwww
ww++++++++wgw+++++++++++++ww
w...x-x....-....xxx........w
w0000000000===00000000000=3w
ww++++++++++++++++++++++++ww
w0000000000===00000000000=1w
ww+++++++++++++++++++A++++ww
wwwwwwwwwwwwwwwwwwwwwwwwwwww
wwwwwwwwwwwwwwwwwwwwwwwwwwww
wwwwwwwwwwwwwwwwwwwwwwwwwwww
