wwwwwwwwwwwwwwwwwwwwwwwwwwww
w++++++++++++++++++wgw++++ww
0000===000000000000000000=3w
000000000===0000000000000=3w
000==00000000===00000===0=1w
0000000====00000000000000=3w
0000=00000===000000000===13w
w+++++++++++++++++++++++++ww
w++++++++++++++++++++++++Aww
wwwwwwwwwwwwwwwwwwwwwwwwwwww
wwwwwwwwwwwwwwwwwwwwwwwwwwww
