wwwwwwwwwwwwwwwwwwwwwwwwwwww
ww+wgw++++++++++++++++++++ww
w..........._..l...........w
w.....-...xx...-.....-xx...w
w......_......___......lll.w
w...x--.....x---.....-.....w
ww++++++++++++++++++++++++ww
w00000000000000===000000033w
ww+++++++++++++++++++A++++ww
wwwwwwwwwwwwwwwwwwwwwwwwwwww
wwwwwwwwwwwwwwwwwwwwwwwwwwww
