wwwwwwwwwwwwwwwwwwwwwwwwwwww
ww++++++++++++++++wgw++++www
w0000000=00000000000000033ww
w0000000000000==0000000011ww
ww+++++++++++++++++++++++www
w...x-.....--xx.......xx-.ww
w........x-x.........x-...ww
w...ll_.....l...._l_....l.ww
ww+++++++++++++++++++++A+www
wwwwwwwwwwwwwwwwwwwwwwwwwwww
wwwwwwwwwwwwwwwwwwwwwwwwwwww
