wwwwwwwwwwwwwwwwwwwwwwwwwwww
wwwwwwwwwwwwwwwwwwwwwwwwwwww
w++++++++++++++++wgw++++++ww
0000000000000000====00000=1w
0000====0000000000000000=13w
0====0000000=0000000===00=3w
00000000000000==000000000=3w
w+++++++++++++++++++++++++ww
w++A++++++++++++++++++++++ww
wwwwwwwwwwwwwwwwwwwwwwwwwwww
wwwwwwwwwwwwwwwwwwwwwwwwwwww
