wwwwwwwwwwwwwwwwwwwwwwwwwwww
wwwwwwwwwwwwwwwwwwwwwwwwwwww
w++++++++++++++wgw++++++++ww
00==0000==0000000=0000000=1w
0000==00000====0000000=0013w
000000===0000000==000000011w
000000000000===0000000000=1w
w+++++++++++++++++++++++++ww
w+++++++++++++++A+++++++++ww
wwwwwwwwwwwwwwwwwwwwwwwwwwww
wwwwwwwwwwwwwwwwwwwwwwwwwwww
