wwwwwwwwwwwwwwwwwwwwwwwwwwww
wwwwwwwwwwwwwwwwwwwwwwwwwwww
ww++++++++++++++++++++wgw+ww
w....___......_l_....ll....w
w0=0000===0000====0000000=1w
w0000000===00000000===000=3w
ww++++++++++++++++++++++++ww
w00000==00000000==0000000=3w
ww+++++++++A++++++++++++++ww
wwwwwwwwwwwwwwwwwwwwwwwwwwww
wwwwwwwwwwwwwwwwwwwwwwwwwwww
