wwwwwwwwwwwwwwwwwwwwwwwwwwww
wwwwwwwwwwwwwwwwwwwwwwwwwwww
w+++++wgw+++++++++++++++++ww
000==000000====00000000===3w
w+++++++++++++++++++++++++ww
._l....l...._ll_......ll...w
...____....._...lll_....._.w
..............l.......l....w
w++++++++++++++++++++++A++ww
wwwwwwwwwwwwwwwwwwwwwwwwwwww
wwwwwwwwwwwwwwwwwwwwwwwwwwww
