wwwwwwwwwwwwwwwwwwwwwwwwwwww
wwwwwwwwwwwwwwwwwwwwwwwwwwww
ww+++++++++++++++wgw++++++ww
w00000==00000==000==0000013w
w000000==0000==000000=000=1w
w000=00000=00==000000000=33w
w000000000000====00000===13w
ww++++++++++++++++++++++++ww
ww++++++++++++++A+++++++++ww
wwwwwwwwwwwwwwwwwwwwwwwwwwww
wwwwwwwwwwwwwwwwwwwwwwwwwwww
