wwwwwwwwwwwwwwwwwwwwwwwwwwww
ww+++++++++++++wgw+++++++www
w0000====000000=0000===031ww
w0000==0000000===000000=13ww
w00000000===0000=000000013ww
ww+++++++++++++++++++++++www
w000===000000=00==000===11ww
w....-xx.......--xx.......ww
wwA++++++++++++++++++++++www
wwwwwwwwwwwwwwwwwwwwwwwwwwww
wwwwwwwwwwwwwwwwwwwwwwwwwwww
