wwwwwwwwwwwwwwwwwwwwwwwwwwww
wwwwwwwwwwwwwwwwwwwwwwwwwwww
w++++wgw++++++++++++++++++ww
00000000000=000===0000000=1w
000000=0000==000==0000000=3w
0000000000000==00000000===3w
w+++++++++++++++++++++++++ww
00000000000000===0000000013w
w+++++++++++++++++++A+++++ww
wwwwwwwwwwwwwwwwwwwwwwwwwwww
wwwwwwwwwwwwwwwwwwwwwwwwwwww
