wwwwwwwwwwwwwwwwwwwwwwwwwwww
wwwwwwwwwwwwwwwwwwwwwwwwwwww
ww+++++++++wgw+++++++++++www
w.x....--...x-x....x...x..ww
ww+++++++++++++++++++++++www
w..-xxx.....xx-......x-...ww
ww+++++++++++++++++++++++www
w00000000000000==000000011ww
ww+++++++++++++A+++++++++www
wwwwwwwwwwwwwwwwwwwwwwwwwwww
wwwwwwwwwwwwwwwwwwwwwwwwwwww
