wwwwwwwwwwwwwwwwwwwwwwwwwwww
wwwwwwwwwwwwwwwwwwwwwwwwwwww
ww++++++++++++++++++wgw++www
w...-..--x....xx....x-x-..ww
w..l_l....ll__.......l_...ww
w....--xx...........xxx-..ww
ww+++++++++++++++++++++++www
w000===0000000====00000033ww
ww+++++++++++++++++++++A+www
wwwwwwwwwwwwwwwwwwwwwwwwwwww
wwwwwwwwwwwwwwwwwwwwwwwwwwww
