wwwwwwwwwwwwwwwwwwwwwwwwwwww
wwwwwwwwwwwwwwwwwwwwwwwwwwww
ww+wgw++++++++++++++++++++ww
w000000000=000000===00000=3w
w00000====000000000==0000=3w
w00000===0000000000000000=3w
w000==0000000=00000====0033w
ww+++++++++++++++++++++++Aww
wwwwwwwwwwwwwwwwwwwwwwwwwwww
wwwwwwwwwwwwwwwwwwwwwwwwwwww
wwwwwwwwwwwwwwwwwwwwwwwwwwww
