wwwwwwwwwwwwwwwwwwwwwwwwwwww
wwwwwwwwwwwwwwwwwwwwwwwwwwww
ww+++++++++++wgw+++++++++www
w00===000000=00===000000=3ww
w0000====000000000=00000=1ww
w00000===0000=0000000====1ww
ww+++++++++++++++++++++++www
ww+++++++++++++++++A+++++www
wwwwwwwwwwwwwwwwwwwwwwwwwwww
wwwwwwwwwwwwwwwwwwwwwwwwwwww
wwwwwwwwwwwwwwwwwwwwwwwwwwww
